shi	eo
reng	ur
zi	wo
jian	ei
ren	ur
qi	uq
yi	oe
li	ue
zhong	ri
bu	iw
zai	ru
wei	pe
guo	ow
de	qi
ji	eu
gong	ir
you	ie
zhi	wi
ge	wp
xin	ep
zhe	qu
da	uw
wu	rp
xiang	wu
fa	or
yu	iq
xing	ep
jin	pr
jing	pr
xian	ro
ye	qo
shang	pq
dao	pw
xi	oq
di	qp
jia	pf
chu	ek
hui	di
jie	ej
tong	lr
er	;r
jiu	pa
chang	ps
fang	jr
chen	el
hua	r;
zhen	uf
zuo	pd
jiang	wl
liang	to
xiao	dp
ta	fp
mo	du
shu	ot
ke	ke
dong	is
bao	os
yong	si
wen	it
shen	ql
mei	do
ban	le
he	tp
meng	qj
xia	wj
yan	id
le	oa
cheng	el
du	q;
shou	qk
yuan	je
fu	kw
ni	so
ti	ao
lai	fo
weng	it
qu	w;
hao	ud
ju	ai
min	rl
ming	rl
jiao	ti
qin	of
yin	if
wo	ye
yao	wk
zheng	uf
guan	kr
ying	if
xue	su
feng	e;
si	od
quan	rj
qing	of
zhu	ua
fen	e;
men	qj
dian	sp
sheng	ql
xie	wy
wang	us
yang	;e
qian	kq
bi	fi
cai	ap
hai	qy
dan	ey
nen	rk
zhan	ia
ci	tu
ru	;w
she	fu
neng	rk
gao	yr
zhang	lw
bei	au
dui	jw
huo	;q
ze	ry
mian	yq
dai	jq
bian	ou
tian	up
hou	er
nian	lq
hu	pt
ding	yw
chan	re
xu	ew
duo	iu
fan	qr
shuo	eq
an	uo
zhuan	ui
na	io
pin	al
ben	ak
suo	ip
biao	a;
fei	wr
kai	rw
shui	op
lian	we
ping	al
san	rq
yue	oi
beng	ak
gu	pu
dou	dj
gui	ld
heng	tq
hen	tq
ri	ja
kong	sy
zhou	fk
ran	tl
ba	;d
zong	ys
guang	aj
qiu	ug
nan	hw
lao	dk
liu	wh
kan	rh
me	sl
tiao	gi
nei	gu
shan	ls
ling	wq
deng	go
tai	yd
lv	lf
mu	qh
wan	jt
zu	;s
gai	kd
dang	sk
gan	eh
bai	hr
gou	fj
tou	;f
lu	kt
bin	he
che	tj
den	go
lin	wq
huan	ks
jue	t;
ting	yf
su	dl
zhuang	sj
duan	pi
bing	he
wai	d;
chuan	gp
tu	lt
ha	fl
chi	s;
zhao	pg
zui	jd
cha	og
ma	tk
rong	f;
ce	qe
shao	fy
que	ya
bo	kf
yun	ay
lei	ka
xun	la
jun	;a
lo	jf
chong	hq
kou	;t
liao	dy
zao	po
mi	js
qiang	ig
ya	ty
luo	jf
pai	qw
xuan	ut
lun	yt
pei	te
tan	yi
cun	yp
kuai	fw
geng	jp
gen	jp
ai	fe
tui	ij
can	yo
qun	se
pi	li
bie	uy
xiu	ae
chao	wt
chuang	ji
han	ea
man	fq
hang	oy
cong	ef
kao	yu
nv	ra
pian	jo
se	tw
te	oj
gei	wf
zen	de
tuo	ul
e	dh
nin	sh
song	dw
re	gy
kuan	qt
kuang	ju
rang	py
la	ki
tie	il
cen	et
lie	yg
mai	ko
zou	dq
diao	gl
ceng	et
suan	g;
pu	fh
ku	hd
qie	lu
zhun	ah
lan	uj
nong	ik
zeng	de
gang	gk
tao	sr
hong	ht
ning	sh
huang	hs
tang	th
mao	gj
sha	ku
sui	pj
po	iy
pan	qf
qiao	fr
en	;u
sai	lo
piao	dr
chou	rt
shuang	rs
cao	rf
a	kg
lou	ar
xiong	ha
hei	uk
nao	jg
long	es
eng	;u
dei	ol
chun	sw
cuo	tr
kang	;g
hun	u;
tuan	sq
bang	rd
ruan	hf
huai	wa
peng	ed
lang	ws
mou	aw
leng	fa
zhai	;p
niu	lp
zhuo	lg
pao	kp
cang	kl
pen	ed
miao	hi
kuo	ok
ka	;i
nai	jk
rou	aq
ruo	ge
guai	i;
sun	pl
shun	wd
mang	ds
zan	oh
ou	gq
ao	qd
pa	qa
zhui	ho
dun	da
zha	jl
lve	pk
cu	hp
fou	fs
shei	hu
pang	ta
kui	ts
zun	sd
sou	df
luan	fd
wa	o;
juan	sf
nu	af
gua	ad
shai	kj
za	at
kun	gw
ne	as
keng	uh
cui	ph
zhua	eg
ken	uh
shuai	qs
die	sa
niang	st
rao	lj
teng	wg
zang	;o
fo	lk
sa	yk
nuan	yl
sang	gh
gun	dt
shua	td
nuo	rg
run	ky
mie	ih
niao	qg
kua	tf
rui	j;
qia	ft
chui	p;
sao	;j
chai	k;
seng	;k
nang	y;
zuan	yj
sen	;k
qiong	l;
ca	ly
tun	jy
diu	gr
o	hl
ang	;y
ga	ga
nve	sg
cou	ag
shuan	gd
chuo	hk
lia	dg
pou	gs
zei	hy
cuan	hg
nie	;l
jiong	jh
chuai	hj
miu	yh
pie	gf
yo	kh
chua	gt
zhuai	;h
dia	lh
tei	tg
biang	uu
kei	fg
nou	ww
nia	qq
ong	rr
zhei	ee
ei	pp
nun	ii
fiao	oo