阿根廷	a gen ting
阿里巴巴	a li ba ba
阿姨	a yi
爱的	ai de
爱国	ai guo
爱好	ai hao
爱好者	ai hao zhe
爱护	ai hu
埃及	ai ji
爱立信	ai li xin
爱你	ai ni
爱情	ai qing
爱人	ai ren
爱上	ai shang
爱我	ai wo
爱心	ai xin
癌症	ai zheng
艾滋病	ai zi bing
安定	an ding
按规定	an gui ding
安徽	an hui
安徽省	an hui sheng
氨基酸	an ji suan
按键	an jian
案件	an jian
安静	an jing
案例	an li
按摩	an mo
按钮	an niu
安排	an pai
安全	an quan
安全的	an quan de
安全管理	an quan guan li
安全生产	an quan sheng chan
安全性	an quan xing
按时	an shi
暗示	an shi
安慰	an wei
按下	an xia
安心	an xin
按照	an zhao
按照规定	an zhao gui ding
安置	an zhi
按住	an zhu
安装	an zhuang
安装了	an zhuang le
昂贵	ang gui
澳大利亚	ao da li ya
奥迪	ao di
澳门	ao men
奥运	ao yun
奥运会	ao yun hui
澳洲	ao zhou
霸道	ba dao
八个	ba ge
八卦	ba gua
罢了	ba le
巴黎	ba li
把你	ba ni
八年	ba nian
把手	ba shou
把他	ba ta
把我	ba wo
巴西	ba xi
八月	ba yue
把这	ba zhe
把这个	ba zhe ge
把自己	ba zi ji
百度	bai du
摆放	bai fang
拜访	bai fang
百分点	bai fen dian
百合	bai he
百货	bai huo
白酒	bai jiu
白领	bai ling
百年	bai nian
白色	bai se
白糖	bai tang
白天	bai tian
摆脱	bai tuo
百万	bai wan
百姓	bai xing
白云	bai yun
摆在	bai zai
办案	ban an
版本	ban ben
颁布	ban bu
板材	ban cai
半导体	ban dao ti
办的	ban de
办法	ban fa
颁发	ban fa
半个	ban ge
办公	ban gong
办公楼	ban gong lou
办公室	ban gong shi
办公厅	ban gong ting
办好	ban hao
班级	ban ji
搬家	ban jia
板块	ban kuai
版块	ban kuai
办理	ban li
伴侣	ban lv
版面	ban mian
半年	ban nian
搬迁	ban qian
版权	ban quan
版权归	ban quan gui
版权所有	ban quan suo you
办事	ban shi
办事处	ban shi chu
伴随	ban sui
伴随着	ban sui zhe
半天	ban tian
搬完	ban wan
搬完家	ban wan jia
搬完了	ban wan le
半小时	ban xiao shi
办学	ban xue
扮演	ban yan
半夜	ban ye
伴有	ban you
班长	ban zhang
版主	ban zhu
斑竹	ban zhu
班主任	ban zhu ren
班子	ban zi
邦迪	bang di
绑定	bang ding
帮忙	bang mang
帮你	bang ni
帮我	bang wo
榜样	bang yang
帮助	bang zhu
保安	bao an
保持	bao chi
保持了	bao chi le
保持在	bao chi zai
保持着	bao chi zhe
报酬	bao chou
保存	bao cun
报道	bao dao
报到	bao dao
爆发	bao fa
报废	bao fei
报复	bao fu
报告	bao gao
保管	bao guan
报关	bao guan
曝光	bao guang
宝贵	bao gui
包裹	bao guo
包含	bao han
包含了	bao han le
保护	bao hu
保护区	bao hu qu
报价	bao jia
保健	bao jian
保健品	bao jian pin
报警	bao jing
报刊	bao kan
报考	bao kao
包括	bao kuo
包括了	bao kuo le
暴力	bao li
保留	bao liu
暴露	bao lu
宝马	bao ma
饱满	bao man
保密	bao mi
报名	bao ming
保姆	bao mu
保全	bao quan
报社	bao she
宝石	bao shi
保湿	bao shi
保守	bao shou
报送	bao song
保温	bao wen
保险	bao xian
保险费	bao xian fei
保险公司	bao xian gong si
报销	bao xiao
保修	bao xiu
保养	bao yang
抱怨	bao yuan
爆炸	bao zha
保障	bao zhang
抱着	bao zhe
保证	bao zheng
保证金	bao zheng jin
保证责任	bao zheng ze ren
报纸	bao zhi
包装	bao zhuang
包子	bao zi
悲哀	bei ai
备案	bei an
背包	bei bao
被保险人	bei bao xian ren
北部	bei bu
被称为	bei cheng wei
北大	bei da
被动	bei dong
北方	bei fang
备份	bei fen
被告	bei gao
被告人	bei gao ren
北海	bei hai
背后	bei hou
北京	bei jing
背景	bei jing
北京大学	bei jing da xue
北京的	bei jing de
北京市	bei jing shi
北京时间	bei jing shi jian
背景下	bei jing xia
悲剧	bei ju
北路	bei lu
北美	bei mei
背面	bei mian
被评为	bei ping wei
被迫	bei po
被人	bei ren
被认为	bei ren wei
悲伤	bei shang
背上	bei shang
倍数	bei shu
被我	bei wo
备用	bei yong
被誉为	bei yu wei
背着	bei zhe
备注	bei zhu
本案	ben an
本报	ben bao
本报记者	ben bao ji zhe
本报讯	ben bao xun
本部	ben bu
本产品	ben chan pin
奔驰	ben chi
本次	ben ci
本单位	ben dan wei
本地	ben di
本地区	ben di qu
本店	ben dian
本法	ben fa
本公司	ben gong si
本规定	ben gui ding
本国	ben guo
本行	ben hang
本合同	ben he tong
本届	ben jie
本科	ben ke
本科生	ben ke sheng
本来就	ben lai jiu
本类	ben lei
本领	ben ling
本论坛	ben lun tan
本能	ben neng
本片	ben pian
本品	ben pin
本期	ben qi
本企业	ben qi ye
本人	ben ren
本日	ben ri
本软件	ben ruan jian
本身	ben shen
本书	ben shu
奔腾	ben teng
本田	ben tian
本条	ben tiao
本条例	ben tiao li
本帖	ben tie
本土	ben tu
本网站	ben wang zhan
本文	ben wen
本系统	ben xi tong
本校	ben xiao
本性	ben xing
本月	ben yue
本站	ben zhan
本站所有	ben zhan suo you
本站原创	ben zhan yuan chuang
本章	ben zhang
本质	ben zhi
本周	ben zhou
本专业	ben zhuan ye
崩溃	beng kui
必备	bi bei
必不可少	bi bu ke shao
彼此	bi ci
必定	bi ding
笔记	bi ji
笔记本	bi ji ben
必将	bi jiang
比较	bi jiao
比较好	bi jiao hao
毕竟	bi jing
毕竟是	bi jing shi
避开	bi kai
比例	bi li
比率	bi lv
避免	bi mian
避免了	bi mian le
比起	bi qi
比去年	bi qu nian
必然	bi ran
比如	bi ru
比如说	bi ru shuo
比赛	bi sai
比上年	bi shang nian
笔试	bi shi
比我	bi wo
陛下	bi xia
必须	bi xu
必需	bi xu
必须有	bi xu you
比亚迪	bi ya di
必要	bi yao
必要的	bi yao de
必要时	bi yao shi
必要性	bi yao xing
毕业	bi ye
毕业后	bi ye hou
毕业生	bi ye sheng
毕业于	bi ye yu
比喻	bi yu
笔者	bi zhe
壁纸	bi zhi
比重	bi zhong
鼻子	bi zi
遍布	bian bu
变成	bian cheng
编程	bian cheng
变成了	bian cheng le
变得	bian de
变的	bian de
变动	bian dong
变革	bian ge
变更	bian geng
变更登记	bian geng deng ji
编号	bian hao
辩护	bian hu
变化	bian hua
变换	bian huan
便会	bian hui
编辑	bian ji
编辑部	bian ji bu
编辑器	bian ji qi
变焦	bian jiao
便捷	bian jie
边界	bian jie
边境	bian jing
便可	bian ke
变了	bian le
便利	bian li
变量	bian liang
编码	bian ma
变迁	bian qian
边上	bian shang
便是	bian shi
变态	bian tai
变为	bian wei
编写	bian xie
变形	bian xing
变压器	bian ya qi
编译	bian yi
编译器	bian yi qi
便于	bian yu
边缘	bian yuan
编制	bian zhi
表达	biao da
表达的	biao da de
表达了	biao da le
表单	biao dan
表格	biao ge
标记	biao ji
表决	biao jue
表面	biao mian
表明	biao ming
标明	biao ming
标签	biao qian
表情	biao qing
表示	biao shi
表述	biao shu
标题	biao ti
表现	biao xian
表现出	biao xian chu
表现的	biao xian de
表现为	biao xian wei
表现在	biao xian zai
表演	biao yan
表扬	biao yang
表彰	biao zhang
标志	biao zhi
标志着	biao zhi zhe
标注	biao zhu
标准	biao zhun
标准和	biao zhun he
标准化	biao zhun hua
别的	bie de
别人	bie ren
别墅	bie shu
宾馆	bin guan
并按	bing an
并把	bing ba
并报	bing bao
病变	bing bian
并不	bing bu
并不代表	bing bu dai biao
并不能	bing bu neng
并不是	bing bu shi
秉承	bing cheng
并处	bing chu
病毒	bing du
并对	bing dui
并发	bing fa
并非	bing fei
并根据	bing gen ju
并购	bing gou
并及时	bing ji shi
并将	bing jiang
并进	bing jin
并经	bing jing
并可	bing ke
冰冷	bing leng
病例	bing li
并没	bing mei
并没有	bing mei you
并能	bing neng
并且	bing qie
并且在	bing qie zai
病情	bing qing
并取得	bing qu de
病人	bing ren
病人的	bing ren de
并使	bing shi
并提	bing ti
并通过	bing tong guo
并未	bing wei
并为	bing wei
并无	bing wu
冰箱	bing xiang
并向	bing xiang
冰雪	bing xue
并以	bing yi
病因	bing yin
并用	bing yong
并有	bing you
并由	bing you
并与	bing yu
并于	bing yu
并在	bing zai
并重	bing zhong
并作	bing zuo
播出	bo chu
拨打	bo da
波动	bo dong
播放	bo fang
播放器	bo fang qi
博客	bo ke
博览会	bo lan hui
玻璃	bo li
薄弱	bo ruo
博士	bo shi
博士后	bo shi hou
博士学位	bo shi xue wei
博物馆	bo wu guan
播种	bo zhong
脖子	bo zi
不爱	bu ai
不安	bu an
不包括	bu bao kuo
不被	bu bei
不必	bu bi
不变	bu bian
不便	bu bian
不曾	bu ceng
补偿	bu chang
不超过	bu chao guo
不成	bu cheng
不承担	bu cheng dan
不吃	bu chi
补充	bu chong
不出	bu chu
不存在	bu cun zai
不错	bu cuo
不大	bu da
不代表	bu dai biao
不但	bu dan
不当	bu dang
不到	bu dao
不得	bu de
不得不	bu de bu
不得超过	bu de chao guo
不得以	bu de yi
不等	bu deng
不低于	bu di yu
补丁	bu ding
不懂	bu dong
不动	bu dong
不动产	bu dong chan
不断	bu duan
不断地	bu duan de
不断发展	bu duan fa zhan
不断扩大	bu duan kuo da
不断提高	bu duan ti gao
不断完善	bu duan wan shan
不对	bu dui
部队	bu dui
不多	bu duo
步伐	bu fa
不发	bu fa
不乏	bu fa
不妨	bu fang
部分	bu fen
不分	bu fen
部分的	bu fen de
部分内容	bu fen nei rong
不服	bu fu
不符	bu fu
不符合	bu fu he
不该	bu gai
不敢	bu gan
不高	bu gao
不给	bu gei
不够	bu gou
不顾	bu gu
不管	bu guan
不管是	bu guan shi
不过	bu guo
不含	bu han
不好	bu hao
不好意思	bu hao yi si
不合格	bu he ge
不合理	bu he li
不会	bu hui
不会有	bu hui you
不及	bu ji
不见	bu jian
部件	bu jian
不解	bu jie
不仅	bu jin
不禁	bu jin
不仅仅	bu jin jin
不仅仅是	bu jin jin shi
不仅是	bu jin shi
不久	bu jiu
布局	bu ju
不具备	bu ju bei
不觉	bu jue
不看	bu kan
不可	bu ke
不可能	bu ke neng
不可思议	bu ke si yi
不可以	bu ke yi
不肯	bu ken
不来	bu lai
不了	bu le
不利	bu li
不利于	bu li yu
不良	bu liang
不论	bu lun
不论是	bu lun shi
部落	bu luo
不满	bu man
不满意	bu man yi
部门	bu men
不明	bu ming
不明白	bu ming bai
不能	bu neng
不能下载	bu neng xia zai
不怕	bu pa
不起	bu qi
不强	bu qiang
不清	bu qing
不清楚	bu qing chu
不去	bu qu
不然	bu ran
不让	bu rang
不容易	bu rong yi
不如	bu ru
步入	bu ru
不上	bu shang
不少	bu shao
不少人	bu shao ren
不少于	bu shao yu
不是	bu shi
不适	bu shi
不时	bu shi
不适合	bu shi he
不是很	bu shi hen
不受	bu shou
部署	bu shu
不属于	bu shu yu
不说	bu shuo
不算	bu suan
不太	bu tai
不提供	bu ti gong
补贴	bu tie
不停	bu ting
不停地	bu ting de
不同	bu tong
不同程度	bu tong cheng du
不同的	bu tong de
不同意	bu tong yi
不同于	bu tong yu
部位	bu wei
不为	bu wei
部委办	bu wei ban
不稳定	bu wen ding
不喜欢	bu xi huan
不限	bu xian
不想	bu xiang
不详	bu xiang
不像	bu xiang
不想干	bu xiang gan
不想干了	bu xiang gan le
不小心	bu xiao xin
不信	bu xin
不行	bu xing
不幸	bu xing
步行	bu xing
不锈钢	bu xiu gang
不许	bu xu
不需要	bu xu yao
不要	bu yao
不宜	bu yi
不易	bu yi
不已	bu yi
不一	bu yi
不一定	bu yi ding
不一样	bu yi yang
不应	bu ying
不应该	bu ying gai
不影响	bu ying xiang
不用	bu yong
不由	bu you
不与	bu yu
不予	bu yu
不愿	bu yuan
不远	bu yuan
不愿意	bu yuan yi
不允许	bu yun xu
不再	bu zai
不在	bu zai
不再是	bu zai shi
部长	bu zhang
不正常	bu zheng chang
不正确	bu zheng que
不知	bu zhi
布置	bu zhi
不止	bu zhi
不知不觉	bu zhi bu jue
不支持	bu zhi chi
不知道	bu zhi dao
步骤	bu zhou
补助	bu zhu
不住	bu zhu
不准	bu zhun
捕捉	bu zhuo
不足	bu zu
不做	bu zuo
猜测	cai ce
财产	cai chan
菜单	cai dan
彩电	cai dian
裁定	cai ding
才发现	cai fa xian
采访	cai fang
财富	cai fu
彩虹	cai hong
才华	cai hua
才会	cai hui
采集	cai ji
财经	cai jing
裁决	cai jue
才可	cai ke
才可以	cai ke yi
财力	cai li
材料	cai liao
才能	cai neng
菜鸟	cai niao
裁判	cai pan
彩票	cai piao
采取	cai qu
采取措施	cai qu cuo shi
采取的	cai qu de
采取了	cai qu le
彩色	cai se
才是	cai shi
财务	cai wu
财物	cai wu
财务管理	cai wu guan li
财务会计	cai wu kuai ji
彩信	cai xin
菜肴	cai yao
采用	cai yong
采用了	cai yong le
才有	cai you
财政	cai zheng
财政部	cai zheng bu
财政部门	cai zheng bu men
材质	cai zhi
才知道	cai zhi dao
参保	can bao
参观	can guan
餐馆	can guan
参会	can hui
残疾	can ji
残疾人	can ji ren
参加	can jia
参加了	can jia le
参见	can jian
参考	can kao
参考价格	can kao jia ge
灿烂	can lan
灿烂的	can lan de
残留	can liu
参赛	can sai
参数	can shu
餐厅	can ting
餐饮	can yin
参与	can yu
参与者	can yu zhe
参展	can zhan
参展的	can zhan de
参展商	can zhan shang
参照	can zhao
仓储	cang chu
仓库	cang ku
草案	cao an
曹操	cao cao
草原	cao yuan
操纵	cao zong
操作	cao zuo
操作系统	cao zuo xi tong
测定	ce ding
策划	ce hua
测绘	ce hui
测量	ce liang
策略	ce lve
侧面	ce mian
测评	ce ping
测试	ce shi
厕所	ce suo
层次	ceng ci
曾经	ceng jing
层面	ceng mian
曾在	ceng zai
差别	cha bie
差不多	cha bu duo
插槽	cha cao
查处	cha chu
差点	cha dian
差额	cha e
插件	cha jian
差距	cha ju
查看	cha kan
查看附件	cha kan fu jian
插入	cha ru
查询	cha xun
茶叶	cha ye
差异	cha yi
查阅	cha yue
查找	cha zhao
拆除	chai chu
拆迁	chai qian
柴油	chai you
产地	chan di
产量	chan liang
产能	chan neng
产品	chan pin
产品编号	chan pin bian hao
产品规格	chan pin gui ge
产品价格	chan pin jia ge
产品介绍	chan pin jie shao
产品销售	chan pin xiao shou
产品信息	chan pin xin xi
产品质量	chan pin zhi liang
产权	chan quan
产生	chan sheng
产生了	chan sheng le
阐述	chan shu
产物	chan wu
产业	chan ye
产业发展	chan ye fa zhan
产业化	chan ye hua
产业结构	chan ye jie gou
产业链	chan ye lian
产值	chan zhi
长安	chang an
长城	chang cheng
长春	chang chun
长达	chang da
倡导	chang dao
长的	chang de
场地	chang di
长度	chang du
长短	chang duan
长发	chang fa
厂房	chang fang
唱歌	chang ge
常规	chang gui
场合	chang he
厂家	chang jia
常见	chang jian
常见的	chang jian de
长江	chang jiang
场景	chang jing
长久	chang jiu
场面	chang mian
常年	chang nian
唱片	chang pian
唱片公司	chang pian gong si
长期	chang qi
长期以来	chang qi yi lai
长沙	chang sha
长沙市	chang sha shi
厂商	chang shang
场上	chang shang
尝试	chang shi
常识	chang shi
长时间	chang shi jian
场所	chang suo
畅通	chang tong
长途	chang tu
常委	chang wei
常委会	chang wei hui
常务	chang wu
畅销	chang xiao
常用	chang yong
常有	chang you
长远	chang yuan
长征	chang zheng
超标	chao biao
超出	chao chu
炒个	chao ge
炒个菜	chao ge cai
超过	chao guo
超过了	chao guo le
超级	chao ji
超级版主	chao ji ban zhu
炒几个菜	chao ji ge cai
潮流	chao liu
超声波	chao sheng bo
超市	chao shi
朝廷	chao ting
抄袭	chao xi
朝鲜	chao xian
朝阳	chao yang
朝阳区	chao yang qu
超越	chao yue
朝着	chao zhe
超值	chao zhi
炒作	chao zuo
车次	che ci
车的	che de
彻底	che di
车队	che dui
车间	che jian
车辆	che liang
车内	che nei
车上	che shang
车身	che shen
撤销	che xiao
车型	che xing
车载	che zai
车站	che zhan
车主	che zhu
车子	che zi
沉淀	chen dian
陈列	chen lie
沉默	chen mo
陈述	chen shu
沉重的	chen zhong de
承办	cheng ban
承办单位	cheng ban dan wei
承包	cheng bao
城堡	cheng bao
成本	cheng ben
乘车	cheng che
承担	cheng dan
承担责任	cheng dan ze ren
程度	cheng du
成都	cheng du
程度上	cheng du shang
成都市	cheng du shi
惩罚	cheng fa
成分	cheng fen
成功	cheng gong
成功的	cheng gong de
成功地	cheng gong de
成果	cheng guo
称号	cheng hao
称呼	cheng hu
成绩	cheng ji
成交	cheng jiao
成交量	cheng jiao liang
承接	cheng jie
成就	cheng jiu
乘客	cheng ke
成了	cheng le
成立	cheng li
城里	cheng li
成立了	cheng li le
成立于	cheng li yu
成年	cheng nian
承诺	cheng nuo
成品	cheng pin
成千上万	cheng qian shang wan
城区	cheng qu
承认	cheng ren
成人	cheng ren
成人用品	cheng ren yong pin
城市	cheng shi
诚实	cheng shi
城市的	cheng shi de
城市规划	cheng shi gui hua
城市化	cheng shi hua
城市建设	cheng shi jian she
承受	cheng shou
成熟	cheng shu
成为	cheng wei
称为	cheng wei
成为了	cheng wei le
成为一个	cheng wei yi ge
呈现	cheng xian
呈现出	cheng xian chu
城乡	cheng xiang
成效	cheng xiao
诚信	cheng xin
程序	cheng xu
程序员	cheng xu yuan
成员	cheng yuan
承运人	cheng yun ren
称赞	cheng zan
成长	cheng zhang
城镇	cheng zhen
称之为	cheng zhi wei
乘坐	cheng zuo
翅膀	chi bang
尺寸	chi cun
吃的	chi de
尺度	chi du
吃饭	chi fan
持股	chi gu
吃惊	chi jing
持久	chi jiu
吃了	chi le
持续	chi xu
持有	chi you
崇拜	chong bai
充当	chong dang
充电	chong dian
充电器	chong dian qi
冲动	chong dong
充分	chong fen
充分的	chong fen de
充分发挥	chong fen fa hui
充分利用	chong fen li yong
重复	chong fu
冲击	chong ji
重建	chong jian
充满	chong man
充满了	chong man le
重启	chong qi
重庆	chong qing
重庆市	chong qing shi
充实	chong shi
冲突	chong tu
宠物	chong wu
冲洗	chong xi
重新	chong xin
重新启动	chong xin qi dong
充值	chong zhi
重组	chong zu
充足	chong zu
充足的	chong zu de
筹备	chou bei
抽查	chou cha
抽出	chou chu
抽象	chou xiang
抽烟	chou yan
出版	chu ban
出版日期	chu ban ri qi
出版社	chu ban she
出版物	chu ban wu
储备	chu bei
初步	chu bu
出差	chu chai
出场	chu chang
出厂	chu chang
出处	chu chu
初次	chu ci
除此之外	chu ci zhi wai
储存	chu cun
出错	chu cuo
初二	chu er
出发	chu fa
处罚	chu fa
处罚的	chu fa de
厨房	chu fang
除非	chu fei
处分	chu fen
出国	chu guo
初级	chu ji
初级会员	chu ji hui yuan
出境	chu jing
出具	chu ju
出口	chu kou
出来	chu lai
出来了	chu lai le
除了	chu le
出了	chu le
处理	chu li
处理的	chu li de
出路	chu lu
出门	chu men
触摸	chu mo
处女	chu nv
出品	chu pin
初期	chu qi
畜禽	chu qin
出去	chu qu
除去	chu qu
出让	chu rang
出入	chu ru
初三	chu san
出色	chu se
出身	chu shen
初审	chu shen
出生	chu sheng
出示	chu shi
初始	chu shi
厨师	chu shi
初始化	chu shi hua
出售	chu shou
出手	chu shou
出台	chu tai
出台了	chu tai le
除外	chu wai
出席	chu xi
出席了	chu xi le
出现	chu xian
出现了	chu xian le
出现在	chu xian zai
出血	chu xie
出行	chu xing
储蓄	chu xu
出血	chu xue
处以	chu yi
初一	chu yi
处于	chu yu
出于	chu yu
处在	chu zai
处长	chu zhang
处置	chu zhi
初中	chu zhong
出资	chu zi
出自	chu zi
出租	chu zu
出租车	chu zu che
传播	chuan bo
船舶	chuan bo
传承	chuan cheng
传出	chuan chu
传递	chuan di
传感器	chuan gan qi
穿过	chuan guo
传来	chuan lai
传媒	chuan mei
传奇	chuan qi
传染病	chuan ran bing
穿上	chuan shang
传授	chuan shou
传输	chuan shu
传说	chuan shuo
传送	chuan song
传统	chuan tong
传统文化	chuan tong wen hua
船员	chuan yuan
穿越	chuan yue
穿着	chuan zhe
传真	chuan zhen
穿着	chuan zhuo
创办	chuang ban
窗户	chuang hu
创建	chuang jian
窗口	chuang kou
创立	chuang li
窗帘	chuang lian
床上	chuang shang
创始人	chuang shi ren
窗外	chuang wai
创新	chuang xin
创新能力	chuang xin neng li
创业	chuang ye
创业者	chuang ye zhe
创意	chuang yi
创造	chuang zao
创造出	chuang zao chu
创造了	chuang zao le
创造力	chuang zao li
创造性	chuang zao xing
创作	chuang zuo
垂直	chui zhi
纯粹	chun cui
春风	chun feng
春季	chun ji
春节	chun jie
纯净	chun jing
春秋	chun qiu
纯属	chun shu
春天	chun tian
此版	ci ban
此操作	ci cao zuo
此处	ci chu
此次	ci ci
此后	ci hou
词汇	ci hui
刺激	ci ji
此举	ci ju
此刻	ci ke
此类	ci lei
磁盘	ci pan
此前	ci qian
此人	ci ren
次日	ci ri
此时	ci shi
此事	ci shi
次数	ci shu
此帖	ci tie
此外	ci wai
此文	ci wen
此项	ci xiang
词语	ci yu
辞职	ci zhi
此种	ci zhong
此主题	ci zhu ti
瓷砖	ci zhuan
从不	cong bu
从此	cong ci
从而	cong er
从而使	cong er shi
从根本上	cong gen ben shang
从来	cong lai
从来没有	cong lai mei you
聪明	cong ming
聪明的	cong ming de
从前	cong qian
从容	cong rong
从事	cong shi
丛书	cong shu
从未	cong wei
从我	cong wo
从小	cong xiao
从业	cong ye
从业人员	cong ye ren yuan
从这	cong zhe
从中	cong zhong
促进	cu jin
促进了	cu jin le
促使	cu shi
促销	cu xiao
催化剂	cui hua ji
脆弱	cui ruo
存储	cun chu
存档	cun dang
存放	cun fang
存过	cun guo
存货	cun huo
存款	cun kuan
村里	cun li
村民	cun min
村委会	cun wei hui
存在	cun zai
存在着	cun zai zhe
村庄	cun zhuang
错的	cuo de
错过	cuo guo
错了	cuo le
措施	cuo shi
错误	cuo wu
挫折	cuo zhe
答案	da an
打扮	da ban
达标	da biao
达不到	da bu dao
大部分	da bu fen
大臣	da chen
达成	da cheng
大城市	da cheng shi
打出	da chu
大胆	da dan
达到	da dao
大道	da dao
达到了	da dao le
大的	da de
大地	da di
打电话	da dian hua
大豆	da dou
大都	da dou
大队	da dui
大多	da duo
大多是	da duo shi
大多数	da duo shu
大方	da fang
打分	da fen
大幅	da fu
答复	da fu
大幅度	da fu du
大概	da gai
大纲	da gang
大哥	da ge
打工	da gong
大规模	da gui mo
大规模的	da gui mo de
大国	da guo
大海	da hai
大户	da hu
打呼	da hu
大会	da hui
打击	da ji
大家	da jia
大家都	da jia dou
大家好	da jia hao
搭建	da jian
大奖	da jiang
大叫	da jiao
大街	da jie
大酒店	da jiu dian
大局	da ju
大军	da jun
打开	da kai
打开了	da kai le
打了	da le
大了	da le
大类	da lei
搭理	da li
大力	da li
大理	da li
大力发展	da li fa zhan
大力推进	da li tui jin
大力支持	da li zhi chi
大连	da lian
大连市	da lian shi
大量	da liang
大楼	da lou
大陆	da lu
大门	da men
大米	da mi
大面积	da mian ji
大脑	da nao
大盘	da pan
搭配	da pei
大批	da pi
大片	da pian
打破	da po
大气	da qi
大企业	da qi ye
大桥	da qiao
大全	da quan
大人	da ren
大肉	da rou
大赛	da sai
大声	da sheng
大师	da shi
大事	da shi
打算	da suan
大唐	da tang
答题	da ti
大腿	da tui
大王	da wang
打下	da xia
大小	da xiao
大型	da xing
大型企业	da xing qi ye
大学	da xue
大学本科	da xue ben ke
大学生	da xue sheng
打印	da yin
打印机	da yin ji
答应	da ying
大有	da you
大于	da yu
大约	da yue
打造	da zao
大战	da zhan
打折	da zhe
打着	da zhe
打折机票	da zhe ji piao
大致	da zhi
大众	da zhong
大中小	da zhong xiao
大专	da zhuan
大自然	da zi ran
大作	da zuo
代办	dai ban
代表	dai biao
代表大会	dai biao da hui
代表团	dai biao tuan
代表着	dai biao zhe
带到	dai dao
带的	dai de
带动	dai dong
戴尔	dai er
大夫	dai fu
带给	dai gei
代号	dai hao
代价	dai jia
贷款	dai kuan
带宽	dai kuan
带来	dai lai
带来了	dai lai le
代理	dai li
代理人	dai li ren
代理商	dai li shang
带领	dai ling
代码	dai ma
带上	dai shang
代替	dai ti
带头	dai tou
大王	dai wang
代谢	dai xie
带有	dai you
待遇	dai yu
带着	dai zhe
蛋白	dan bai
蛋白质	dan bai zhi
担保	dan bao
但不	dan bu
单纯	dan chun
单词	dan ci
但从	dan cong
但当	dan dang
单独	dan du
但对	dan dui
但对于	dan dui yu
蛋糕	dan gao
单个	dan ge
但还	dan hai
单击	dan ji
单价	dan jia
单间	dan jian
单据	dan ju
但没	dan mei
但你	dan ni
单片机	dan pian ji
但其	dan qi
但却	dan que
担任	dan ren
但如	dan ru
单身	dan shen
诞生	dan sheng
但是	dan shi
但是他	dan shi ta
但是在	dan shi zai
单位	dan wei
单位名称	dan wei ming cheng
但我	dan wo
但现在	dan xian zai
单项	dan xiang
担心	dan xin
但要	dan yao
但也	dan ye
单一	dan yi
但有	dan you
但又	dan you
担忧	dan you
但由于	dan you yu
但在	dan zai
但这	dan zhe
档案	dang an
当场	dang chang
当成	dang cheng
当初	dang chu
档次	dang ci
当代	dang dai
党的	dang de
党的建设	dang de jian she
党的执政	dang de zhi zheng
当地	dang di
党和国家	dang he guo jia
当即	dang ji
当今	dang jin
党内	dang nei
当你	dang ni
当年	dang nian
当您	dang nin
当期	dang qi
当前	dang qian
当前位置	dang qian wei zhi
当然	dang ran
当然是	dang ran shi
当日	dang ri
当时	dang shi
当事	dang shi
当事人	dang shi ren
当他	dang ta
当她	dang ta
当天	dang tian
当晚	dang wan
党委	dang wei
当我	dang wo
当我们	dang wo men
当下	dang xia
党员	dang yuan
党员干部	dang yuan gan bu
党章	dang zhang
党政	dang zheng
党支部	dang zhi bu
党指挥	dang zhi hui
当中	dang zhong
党中央	dang zhong yang
党组	dang zu
党组织	dang zu zhi
当作	dang zuo
盗版	dao ban
到处	dao chu
到达	dao da
导弹	dao dan
到的	dao de
道德	dao de
到底	dao di
到底是	dao di shi
导航	dao hang
到货	dao huo
道具	dao ju
刀具	dao ju
到来	dao lai
到了	dao le
道理	dao li
道路	dao lu
道路交通	dao lu jiao tong
道路上	dao lu shang
到你	dao ni
到您	dao nin
到期	dao qi
道歉	dao qian
导入	dao ru
倒是	dao shi
到时候	dao shi hou
到他	dao ta
到她	dao ta
刀塔	dao ta
到位	dao wei
到我	dao wo
到现在	dao xian zai
导向	dao xiang
导演	dao yan
到一个	dao yi ge
导游	dao you
倒在	dao zai
到这里	dao zhe li
导致	dao zhi
得不到	de bu dao
得出	de chu
得到	de dao
得到了	de dao le
得多	de duo
得分	de fen
得分儿	de fen er
得感冒	de gan mao
德国	de guo
得很	de hen
的话	de hua
得了	de le
的人	de ren
的是	de shi
的事	de shi
得意	de yi
德育	de yu
得知	de zhi
等待	deng dai
等到	deng dao
等的	deng de
等地	deng di
等多	deng duo
等方面	deng fang mian
等功能	deng gong neng
灯光	deng guang
等候	deng hou
等级	deng ji
登记	deng ji
登记表	deng ji biao
登记管理	deng ji guan li
登记机关	deng ji ji guan
灯具	deng ju
登录	deng lu
等内容	deng nei rong
等你	deng ni
等情况	deng qing kuang
等人	deng ren
登山	deng shan
登上	deng shang
等我	deng wo
邓小平	deng xiao ping
等形式	deng xing shi
等于	deng yu
等着	deng zhe
等专业	deng zhuan ye
第八条	di ba tiao
第八章	di ba zhang
地板	di ban
底部	di bu
地步	di bu
地产	di chan
低成本	di cheng ben
地处	di chu
抵触	di chu
抵达	di da
地带	di dai
地道	di dao
低的	di de
地点	di dian
低调	di diao
地段	di duan
第二次	di er ci
第二个	di er ge
第二节	di er jie
第二届	di er jie
第二款	di er kuan
第二十条	di er shi tiao
第二天	di er tian
第二条	di er tiao
第二章	di er zhang
地方	di fang
地方政府	di fang zheng fu
递给	di gei
帝国	di guo
低价	di jia
递交	di jiao
第九条	di jiu tiao
抵抗	di kang
地块	di kuai
地理	di li
地理位置	di li wei zhi
第六	di liu
第六条	di liu tiao
第六章	di liu zhang
地面	di mian
地名	di ming
第七条	di qi tiao
第七张	di qi zhang
第七章	di qi zhang
地球	di qiu
地区	di qu
的确	di que
敌人	di ren
敌人的	di ren de
第三	di san
第三次	di san ci
第三方	di san fang
第三个	di san ge
第三节	di san jie
第三届	di san jie
第三人	di san ren
第三十条	di san shi tiao
第三条	di san tiao
第三章	di san zhang
地上	di shang
第十	di shi
第十八条	di shi ba tiao
第十二条	di shi er tiao
第十九条	di shi jiu tiao
第十六条	di shi liu tiao
第十七条	di shi qi tiao
第十三条	di shi san tiao
第十四条	di shi si tiao
第十条	di shi tiao
第十五条	di shi wu tiao
第十一条	di shi yi tiao
地税	di shui
第四节	di si jie
第四条	di si tiao
第四章	di si zhang
地毯	di tan
地铁	di tie
低头	di tou
地图	di tu
地位	di wei
低温	di wen
第五	di wu
第五条	di wu tiao
第五章	di wu zhang
地下	di xia
地形	di xing
抵押	di ya
第一	di yi
第一步	di yi bu
第一次	di yi ci
第一个	di yi ge
第一家	di yi jia
第一节	di yi jie
第一款	di yi kuan
第一名	di yi ming
第一批	di yi pi
第一时间	di yi shi jian
第一天	di yi tian
第一条	di yi tiao
第一位	di yi wei
第一章	di yi zhang
低于	di yu
地域	di yu
地狱	di yu
地震	di zhen
地址	di zhi
地质	di zhi
抵制	di zhi
弟子	di zi
点播	dian bo
电厂	dian chang
电池	dian chi
典当	dian dang
点的	dian de
奠定了	dian ding le
电动	dian dong
典范	dian fan
淀粉	dian fen
电工	dian gong
电话	dian hua
电话号码	dian hua hao ma
点击	dian ji
电机	dian ji
点击查看	dian ji cha kan
点击次数	dian ji ci shu
点击数	dian ji shu
电缆	dian lan
点了	dian le
点了点头	dian le dian tou
电力	dian li
店里	dian li
电流	dian liu
电路	dian lu
店面	dian mian
电脑	dian nao
点评	dian ping
店铺	dian pu
电器	dian qi
电气	dian qi
点券	dian quan
点燃	dian ran
电容	dian rong
电商	dian shang
点上	dian shang
电视	dian shi
电视机	dian shi ji
电视剧	dian shi ju
电视台	dian shi tai
点数	dian shu
电台	dian tai
电梯	dian ti
点头	dian tou
电网	dian wang
电线	dian xian
电信	dian xin
点心	dian xin
典型	dian xing
典型的	dian xing de
电压	dian ya
典雅	dian ya
电影	dian ying
点映	dian ying
电源	dian yuan
电站	dian zhan
店主	dian zhu
电子	dian zi
电子产品	dian zi chan pin
电子公告	dian zi gong gao
电子商务	dian zi shang wu
电子书	dian zi shu
电子信息	dian zi xin xi
电子信箱	dian zi xin xiang
电子邮件	dian zi you jian
电子邮箱	dian zi you xiang
电子政务	dian zi zheng wu
电阻	dian zu
调查	diao cha
调查报告	diao cha bao gao
调查研究	diao cha yan jiu
调动	diao dong
调度	diao du
雕刻	diao ke
掉了	diao le
雕塑	diao su
吊销	diao xiao
调研	diao yan
调用	diao yong
钓鱼	diao yu
顶部	ding bu
订单	ding dan
顶端	ding duan
定额	ding e
订购	ding gou
订货	ding huo
顶级	ding ji
定价	ding jia
定了	ding le
订立	ding li
定量	ding liang
定期	ding qi
定时	ding shi
定位	ding wei
定为	ding wei
定位器	ding wei qi
定向	ding xiang
丁香	ding xiang
定要	ding yao
定义	ding yi
订阅	ding yue
盯着	ding zhe
丢了	diu le
丢了吧	diu le ba
丢了吗	diu le ma
丢失	diu shi
东北	dong bei
东部	dong bu
懂得	dong de
东方	dong fang
东风	dong feng
动感	dong gan
东莞	dong guan
东莞市	dong guan shi
东海	dong hai
动画	dong hua
动画片	dong hua pian
冬季	dong ji
动机	dong ji
动力	dong li
东路	dong lu
动漫	dong man
东盟	dong meng
东南	dong nan
东南亚	dong nan ya
动人	dong ren
董事会	dong shi hui
董事长	dong shi zhang
动手	dong shou
动态	dong tai
冬天	dong tian
动物	dong wu
东西	dong xi
动员	dong yuan
动作	dong zuo
都被	dou bei
都比	dou bi
都必须	dou bi xu
都不	dou bu
都不会	dou bu hui
都不能	dou bu neng
都不是	dou bu shi
都得	dou dei
都对	dou dui
豆腐	dou fu
都很	dou hen
都会	dou hui
都将	dou jiang
豆浆	dou jiang
都看	dou kan
都可	dou ke
都可以	dou ke yi
都没	dou mei
都没有	dou mei you
都能	dou neng
都是	dou shi
都说	dou shuo
都无法	dou wu fa
都想	dou xiang
都需要	dou xu yao
都要	dou yao
都已	dou yi
都以	dou yi
都已经	dou yi jing
都应	dou ying
都应该	dou ying gai
都用	dou yong
都有	dou you
豆油	dou you
都在	dou zai
斗争	dou zheng
都知道	dou zhi dao
赌博	du bo
督察	du cha
督促	du cu
督导	du dao
度过	du guo
都会	du hui
独家	du jia
度假	du jia
杜绝	du jue
独立	du li
毒品	du pin
读取	du qu
都市	du shi
读书	du shu
独特	du te
独有	du you
读者	du zhe
独自	du zi
肚子	du zi
端口	duan kou
锻炼	duan lian
短期	duan qi
短缺	duan que
短线	duan xian
短信	duan xin
短暂	duan zan
对本	dui ben
对比	dui bi
对不	dui bu
对不起	dui bu qi
对策	dui ce
对冲	dui chong
对此	dui ci
对待	dui dai
对方	dui fang
对付	dui fu
对话	dui hua
对话框	dui hua kuang
对价	dui jia
对接	dui jie
对抗	dui kang
对了	dui le
对立	dui li
对面	dui mian
对你	dui ni
对您	dui nin
对其	dui qi
对人	dui ren
对手	dui shou
对所有	dui suo you
对他	dui ta
对她	dui ta
对它	dui ta
对外	dui wai
对外开放	dui wai kai fang
对外贸易	dui wai mao yi
对我	dui wo
对我国	dui wo guo
对我说	dui wo shuo
队伍	dui wu
队伍建设	dui wu jian she
兑现	dui xian
对象	dui xiang
对学生	dui xue sheng
对应	dui ying
对于	dui yu
队员	dui yuan
队长	dui zhang
对照	dui zhao
对着	dui zhe
对这	dui zhe
对中国	dui zhong guo
对自己的	dui zi ji de
顿时	dun shi
多层	duo ceng
多层次	duo ceng ci
多次	duo ci
多大	duo da
多达	duo da
多的	duo de
多方	duo fang
多方面的	duo fang mian de
多个	duo ge
多功能	duo gong neng
多家	duo jia
多久	duo jiu
多了	duo le
多么	duo me
多媒体	duo mei ti
多名	duo ming
多年	duo nian
多年来	duo nian lai
多普达	duo pu da
多人	duo ren
多少	duo shao
多少钱	duo shao qian
多是	duo shi
多数	duo shu
多万	duo wan
多为	duo wei
多位	duo wei
多谢	duo xie
多样	duo yang
多样化	duo yang hua
多元	duo yuan
多元化	duo yuan hua
多月	duo yue
躲在	duo zai
多种	duo zhong
额度	e du
俄国	e guo
恶化	e hua
恶劣	e lie
俄罗斯	e luo si
恶魔	e mo
额外	e wai
恶心	e xin
恶意	e yi
遏制	e zhi
而被	er bei
耳边	er bian
而不	er bu
而不能	er bu neng
而不是	er bu shi
而产生	er chan sheng
而成	er cheng
而出	er chu
二等奖	er deng jiang
而定	er ding
而对	er dui
而对于	er dui yu
耳朵	er duo
而非	er fei
二个	er ge
而后	er hou
耳机	er ji
而来	er lai
二楼	er lou
而你	er ni
二年	er nian
二年级	er nian ji
而其	er qi
二期	er qi
而且	er qie
而且是	er qie shi
而且在	er qie zai
而去	er qu
二人	er ren
而是	er shi
二是	er shi
二十	er shi
而使	er shi
二手	er shou
二手车	er shou che
二手房	er shou fang
而他	er ta
儿童	er tong
而我	er wo
而我们	er wo men
而无	er wu
而现在	er xian zai
而言	er yan
而已	er yi
而又	er you
而有	er you
而在	er zai
而这	er zhe
二者	er zhe
而这些	er zhe xie
儿子	er zi
二字	er zi
发表	fa biao
发表评论	fa biao ping lun
发表日期	fa biao ri qi
发表时间	fa biao shi jian
发表于	fa biao yu
发表者	fa biao zhe
发病	fa bing
发布	fa bu
发布了	fa bu le
发布人	fa bu ren
发布日期	fa bu ri qi
发布时间	fa bu shi jian
发布信息	fa bu xin xi
发布者	fa bu zhe
发出	fa chu
发达	fa da
发达的	fa da de
发达国家	fa da guo jia
发的	fa de
发电	fa dian
法定	fa ding
发动	fa dong
发动机	fa dong ji
发放	fa fang
发改委	fa gai wei
发给	fa gei
法官	fa guan
发光	fa guang
法规	fa gui
法国	fa guo
发挥	fa hui
发货	fa huo
发酵	fa jiao
罚款	fa kuan
发蜡	fa la
发了	fa le
法律	fa lv
法律法规	fa lv fa gui
法律顾问	fa lv gu wen
法律规定	fa lv gui ding
法律援助	fa lv yuan zhu
法律责任	fa lv ze ren
阀门	fa men
发明	fa ming
发票	fa piao
发起	fa qi
发热	fa re
法人	fa ren
法人代表	fa ren dai biao
发射	fa she
发生	fa sheng
发生变化	fa sheng bian hua
发生的	fa sheng de
发生了	fa sheng le
发生在	fa sheng zai
法师	fa shi
发售	fa shou
发送	fa song
发送到	fa song dao
发帖	fa tie
发帖数	fa tie shu
法庭	fa ting
发现	fa xian
发现的	fa xian de
发现了	fa xian le
发现了个	fa xian le ge
发现自己	fa xian zi ji
发行	fa xing
发型	fa xing
发行公司	fa xing gong si
发行日期	fa xing ri qi
法学	fa xue
法学院	fa xue yuan
发言	fa yan
发扬	fa yang
法医	fa yi
发音	fa yin
发育	fa yu
法语	fa yu
法院	fa yuan
法则	fa ze
发展	fa zhan
发展到	fa zhan dao
发展方向	fa zhan fang xiang
发展规划	fa zhan gui hua
发展空间	fa zhan kong jian
发展趋势	fa zhan qu shi
发展战略	fa zhan zhan lve
发展中	fa zhan zhong
发证	fa zheng
法治	fa zhi
法制	fa zhi
发作	fa zuo
范畴	fan chou
饭店	fan dian
反对	fan dui
反而	fan er
反复	fan fu
繁华	fan hua
返还	fan huan
返回	fan hui
反击	fan ji
反抗	fan kang
反馈	fan kui
反垄断	fan long duan
烦恼	fan nao
繁荣	fan rong
反射	fan she
凡是	fan shi
反思	fan si
饭贴	fan tie
范围	fan wei
范围内	fan wei nei
翻译	fan yi
反应	fan ying
反映	fan ying
反映出	fan ying chu
反映的	fan ying de
反映了	fan ying le
反正	fan zheng
繁殖	fan zhi
反之	fan zhi
犯罪	fan zui
妨碍	fang ai
方案	fang an
方便	fang bian
方便的	fang bian de
方便面	fang bian mian
房产	fang chan
放大	fang da
放到	fang dao
房地产	fang di chan
房地产业	fang di chan ye
方法	fang fa
方法是	fang fa shi
防范	fang fan
仿佛	fang fu
防护	fang hu
防火	fang huo
防火墙	fang huo qiang
房价	fang jia
房间	fang jian
房间里	fang jian li
放开	fang kai
方可	fang ke
访客	fang ke
放了	fang le
仿冒	fang mao
方面	fang mian
放弃	fang qi
放弃了	fang qi le
放入	fang ru
方式	fang shi
防守	fang shou
防水	fang shui
放松	fang song
访谈	fang tan
访问	fang wen
访问量	fang wen liang
房屋	fang wu
放下	fang xia
方向	fang xiang
放心	fang xin
放行	fang xing
房型	fang xing
防汛	fang xun
防御	fang yu
房源	fang yuan
放在	fang zai
方针	fang zhen
仿真	fang zhen
防止	fang zhi
纺织品	fang zhi pin
房子	fang zi
房租	fang zu
诽谤	fei bang
非常	fei chang
非常好	fei chang hao
非常重	fei chang zhong
非常重要	fei chang zhong yao
翡翠	fei cui
非典	fei dian
非法	fei fa
非凡	fei fan
飞机	fei ji
飞利浦	fei li pu
肥胖	fei pang
废物	fei wu
飞翔	fei xiang
飞行	fei xing
飞扬	fei yang
非要	fei yao
费用	fei yong
飞跃	fei yue
废止	fei zhi
非洲	fei zhou
分辨率	fen bian lv
分别	fen bie
分别为	fen bie wei
分布	fen bu
分部	fen bu
分成	fen cheng
分店	fen dian
奋斗	fen dou
份额	fen e
吩咐	fen fu
分割	fen ge
分工	fen gong
分公司	fen gong si
分管	fen guan
分行	fen hang
分会	fen hui
分级	fen ji
分解	fen jie
分局	fen ju
分居	fen ju
分开	fen kai
分类	fen lei
分离	fen li
分裂	fen lie
分泌	fen mi
分明	fen ming
愤怒	fen nu
分配	fen pei
分区	fen qu
分散	fen san
分手	fen shou
分数	fen shu
粉丝	fen si
分为	fen wei
分析	fen xi
分析师	fen xi shi
分享	fen xiang
分销	fen xiao
分页	fen ye
分支	fen zhi
分值	fen zhi
分支机构	fen zhi ji gou
分钟	fen zhong
分子	fen zi
分组	fen zu
风暴	feng bao
封闭	feng bi
风采	feng cai
丰富	feng fu
丰富多彩	feng fu duo cai
风格	feng ge
风光	feng guang
丰厚	feng hou
风华	feng hua
凤凰	feng huang
封建	feng jian
风景	feng jing
风景区	feng jing qu
疯狂	feng kuang
蜂蜜	feng mi
封面	feng mian
风情	feng qing
风扇	feng shan
风水	feng shui
丰田	feng tian
风味	feng wei
风险	feng xian
奉献	feng xian
风险投资	feng xian tou zi
风雨	feng yu
风云	feng yun
封装	feng zhuang
疯子	feng zi
佛法	fo fa
佛教	fo jiao
佛山	fo shan
佛山市	fo shan shi
否定	fou ding
否认	fou ren
否则	fou ze
腐败	fu bai
副本	fu ben
腹部	fu bu
副部长	fu bu zhang
复查	fu cha
扶持	fu chi
付出	fu chu
服从	fu cong
附带	fu dai
负担	fu dan
辅导	fu dao
扶到	fu dao
浮动	fu dong
幅度	fu du
付费	fu fei
夫妇	fu fu
覆盖	fu gai
富贵	fu gui
富含	fu han
符号	fu hao
符合	fu he
复合	fu he
负荷	fu he
符合国家	fu he guo jia
符合条件	fu he tiao jian
副会长	fu hui zhang
附加	fu jia
附件	fu jian
福建	fu jian
福建省	fu jian sheng
副教授	fu jiao shou
附近	fu jin
副局长	fu ju zhang
付款	fu kuan
付款方式	fu kuan fang shi
福利	fu li
附录	fu lu
副秘书长	fu mi shu zhang
父母	fu mu
妇女	fu nv
扶贫	fu pin
夫妻	fu qi
父亲	fu qin
夫人	fu ren
辐射	fu she
服饰	fu shi
服侍	fu shi
腐蚀	fu shi
副市长	fu shi zhang
附属	fu shu
副书记	fu shu ji
副所长	fu suo zhang
福田区	fu tian qu
服务	fu wu
服务费	fu wu fei
服务机构	fu wu ji gou
服务器	fu wu qi
服务热线	fu wu re xian
服务商	fu wu shang
服务条款	fu wu tiao kuan
服务项目	fu wu xiang mu
服务业	fu wu ye
服务于	fu wu yu
服务员	fu wu yuan
服务质量	fu wu zhi liang
服务中心	fu wu zhong xin
复习	fu xi
腹泻	fu xie
复兴	fu xing
复印	fu yin
复印件	fu yin jian
服用	fu yong
富有	fu you
负有	fu you
赋予	fu yu
富裕	fu yu
副院长	fu yuan zhang
复杂	fu za
负载	fu zai
负责	fu ze
附则	fu ze
负责人	fu ze ren
负债	fu zhai
复制	fu zhi
福州	fu zhou
福州市	fu zhou shi
辅助	fu zhu
副主任	fu zhu ren
副主席	fu zhu xi
服装	fu zhuang
副总裁	fu zong cai
副总经理	fu zong jing li
副作用	fu zuo yong
改变	gai bian
改编	gai bian
改变了	gai bian le
改成	gai cheng
改动	gai dong
改革	gai ge
改革开放	gai ge kai fang
该公司	gai gong si
该机	gai ji
改建	gai jian
改进	gai jin
概况	gai kuang
概括	gai kuo
改良	gai liang
概论	gai lun
概率	gai lv
概念	gai nian
该企业	gai qi ye
该如何	gai ru he
该软件	gai ruan jian
改善	gai shan
该是	gai shi
该市	gai shi
概述	gai shu
改为	gai wei
该项	gai xiang
该项目	gai xiang mu
该校	gai xiao
改造	gai zao
盖章	gai zhang
改正	gai zheng
改制	gai zhi
改装	gai zhuang
干部	gan bu
干脆	gan cui
感到	gan dao
赶到	gan dao
干的	gan de
感动	gan dong
尴尬	gan ga
感激	gan ji
赶紧	gan jin
干净	gan jing
感觉	gan jue
感觉到	gan jue dao
感慨	gan kai
赶快	gan kuai
感冒	gan mao
感情	gan qing
感染	gan ran
干扰	gan rao
干什么	gan shen me
感受	gan shou
感受到	gan shou dao
甘肃	gan su
甘肃省	gan su sheng
感叹	gan tan
感悟	gan wu
感谢	gan xie
感性	gan xing
感兴趣	gan xing qu
感兴趣的	gan xing qu de
感应	gan ying
干预	gan yu
敢于	gan yu
肝脏	gan zang
干燥	gan zao
感知	gan zhi
刚才	gang cai
钢管	gang guan
刚好	gang hao
刚开始	gang kai shi
港口	gang kou
钢琴	gang qin
钢铁	gang tie
岗位	gang wei
刚要	gang yao
港元	gang yuan
告别	gao bie
高层	gao ceng
高层次	gao ceng ci
高潮	gao chao
高出	gao chu
高达	gao da
高大	gao da
高档	gao dang
高的	gao de
搞得	gao de
高等	gao deng
高等教育	gao deng jiao yu
高等学校	gao deng xue xiao
高等院校	gao deng yuan xiao
高低	gao di
高度	gao du
高度重视	gao du zhong shi
高端	gao duan
高二	gao er
高尔夫	gao er fu
高峰	gao feng
高贵	gao gui
搞好	gao hao
高级	gao ji
高级会员	gao ji hui yuan
稿件	gao jian
高考	gao kao
高科技	gao ke ji
高品质	gao pin zhi
高清	gao qing
高三	gao san
高山	gao shan
高手	gao shou
告诉	gao su
高速	gao su
高速公路	gao su gong lu
告诉你	gao su ni
告诉他	gao su ta
告诉我	gao su wo
告诉我们	gao su wo men
高素质	gao su zhi
高位	gao wei
高温	gao wen
高效的	gao xiao de
高血压	gao xie ya
高新技术	gao xin ji shu
高新区	gao xin qu
高兴	gao xing
高性能	gao xing neng
高血压	gao xue ya
高压	gao ya
高雅	gao ya
高一	gao yi
高于	gao yu
高原	gao yuan
告知	gao zhi
高职	gao zhi
高质量	gao zhi liang
高质量的	gao zhi liang de
高中	gao zhong
个别	ge bie
胳膊	ge bo
各部门	ge bu men
歌唱	ge chang
歌词	ge ci
个词	ge ci
各大	ge da
各单位	ge dan wei
各地	ge di
各地区	ge di qu
各方	ge fang
各方面	ge fang mian
各个	ge ge
个股	ge gu
各国	ge guo
各级	ge ji
各级政府	ge ji zheng fu
各界	ge jie
格局	ge ju
各类	ge lei
隔离	ge li
歌迷	ge mi
革命	ge ming
革命的	ge ming de
歌曲	ge qu
个人	ge ren
个人观点	ge ren guan dian
个人信息	ge ren xin xi
个人意见	ge ren yi jian
个人资料	ge ren zi liao
歌声	ge sheng
格式	ge shi
各市	ge shi
格式的	ge shi de
歌手	ge shou
个数	ge shu
个体	ge ti
格外	ge wai
各位	ge wei
歌舞	ge wu
阁下	ge xia
各县	ge xian
各项	ge xiang
各项工作	ge xiang gong zuo
个性	ge xing
个性化	ge xing hua
各有	ge you
个月	ge yue
各种	ge zhong
各种各样	ge zhong ge yang
各自	ge zi
各自的	ge zi de
给出	gei chu
给大家	gei da jia
给了	gei le
给你	gei ni
给您	gei nin
给人	gei ren
给他	gei ta
给她	gei ta
给他们	gei ta men
给我	gei wo
给我们	gei wo men
给自己	gei zi ji
根本	gen ben
根本不	gen ben bu
根本利益	gen ben li yi
根据	gen ju
跟你	gen ni
跟随	gen sui
跟他	gen ta
跟我	gen wo
根源	gen yuan
跟着	gen zhe
跟踪	gen zong
更不	geng bu
更大	geng da
更多	geng duo
更多的人	geng duo de ren
更多信息	geng duo xin xi
更改	geng gai
更高	geng gao
更好	geng hao
更好的	geng hao de
更好地	geng hao de
更何况	geng he kuang
更换	geng huan
更加	geng jia
更具	geng ju
更快	geng kuai
更能	geng neng
更强	geng qiang
更容易	geng rong yi
更深	geng shen
更是	geng shi
更为	geng wei
更新	geng xin
更新日期	geng xin ri qi
更新时间	geng xin shi jian
更要	geng yao
更有	geng you
更优惠	geng you hui
更正	geng zheng
更重要	geng zhong yao
公安	gong an
公安部	gong an bu
公安机关	gong an ji guan
公安局	gong an ju
公布	gong bu
公布了	gong bu le
共产党	gong chan dang
共产党员	gong chan dang yuan
工厂	gong chang
工程	gong cheng
工程建设	gong cheng jian she
工程师	gong cheng shi
工程项目	gong cheng xiang mu
工程质量	gong cheng zhi liang
功德	gong de
工地	gong di
供电	gong dian
公分	gong fen
功夫	gong fu
工夫	gong fu
公告	gong gao
公共	gong gong
公共服务	gong gong fu wu
公共卫生	gong gong wei sheng
巩固	gong gu
公关	gong guan
工行	gong hang
共和国	gong he guo
供货	gong huo
攻击	gong ji
供给	gong ji
共计	gong ji
攻击的	gong ji de
共建	gong jian
公交	gong jiao
公交车	gong jiao che
公斤	gong jin
工具	gong ju
公开	gong kai
公里	gong li
功力	gong li
公路	gong lu
功率	gong lv
攻略	gong lve
公民	gong min
功能	gong neng
功能强大	gong neng qiang da
公平	gong ping
公顷	gong qing
共青团	gong qing tuan
供求	gong qiu
供求信息	gong qiu xin xi
供热	gong re
工人	gong ren
公认的	gong ren de
工商	gong shang
工伤	gong shang
工伤保险	gong shang bao xian
工商局	gong shang ju
工商银行	gong shang yin hang
公示	gong shi
公式	gong shi
共识	gong shi
供水	gong shui
公司	gong si
公司地址	gong si di zhi
公司法	gong si fa
公司简介	gong si jian jie
公司名称	gong si ming cheng
公司债	gong si zhai
公司章程	gong si zhang cheng
共同	gong tong
共同发展	gong tong fa zhan
共同努力	gong tong nu li
共同所有	gong tong suo you
公文	gong wen
公务员	gong wu yuan
贡献	gong xian
贡献值	gong xian zhi
共享	gong xiang
共享版	gong xiang ban
共享软件	gong xiang ruan jian
功效	gong xiao
工序	gong xu
功勋	gong xun
供养	gong yang
工业	gong ye
工业化	gong ye hua
工业企业	gong ye qi ye
工业区	gong ye qu
工业园	gong ye yuan
工业园区	gong ye yuan qu
工艺	gong yi
公益	gong yi
工艺品	gong yi pin
公益性	gong yi xing
供应	gong ying
供应链	gong ying lian
供应商	gong ying shang
公用	gong yong
共用	gong yong
共有	gong you
公寓	gong yu
公园	gong yuan
公元	gong yuan
公元前	gong yuan qian
公约	gong yue
公章	gong zhang
公正	gong zheng
公证	gong zheng
公众	gong zhong
公主	gong zhu
工资	gong zi
公子	gong zi
工作	gong zuo
工作单位	gong zuo dan wei
工作地点	gong zuo di dian
工作环境	gong zuo huan jing
工作会议	gong zuo hui yi
工作经历	gong zuo jing li
工作经验	gong zuo jing yan
工作人员	gong zuo ren yuan
工作日	gong zuo ri
工作日内	gong zuo ri nei
工作室	gong zuo shi
工作时	gong zuo shi
工作时间	gong zuo shi jian
工作效率	gong zuo xiao lv
工作站	gong zuo zhan
工作者	gong zuo zhe
工作中	gong zuo zhong
工作组	gong zuo zu
构成	gou cheng
构成犯罪	gou cheng fan zui
构成了	gou cheng le
购房	gou fang
购房者	gou fang zhe
构建	gou jian
购买	gou mai
购买了	gou mai le
构思	gou si
沟通	gou tong
购物	gou wu
购物车	gou wu che
构造	gou zao
构造函数	gou zao han shu
购置	gou zhi
构筑	gou zhu
古城	gu cheng
古代	gu dai
古典	gu dian
固定	gu ding
固定的	gu ding de
固定资产	gu ding zi chan
股东	gu dong
股东大会	gu dong da hui
孤独	gu du
股份	gu fen
股份制	gu fen zhi
骨干	gu gan
估计	gu ji
股价	gu jia
估价	gu jia
顾客	gu ke
古老	gu lao
鼓励	gu li
姑娘	gu niang
股票	gu piao
股权	gu quan
固然	gu ran
古人	gu ren
故事	gu shi
股市	gu shi
估算	gu suan
固体	gu ti
骨头	gu tou
顾问	gu wen
故乡	gu xiang
故意	gu yi
雇员	gu yuan
故障	gu zhang
雇主	gu zhu
挂钩	gua gou
挂牌	gua pai
挂在	gua zai
怪物	guai wu
关爱	guan ai
关闭	guan bi
观测	guan ce
观察	guan cha
贯彻	guan che
贯彻落实	guan che luo shi
贯彻执行	guan che zhi xing
贯穿	guan chuan
管道	guan dao
观点	guan dian
官方	guan fang
官方网站	guan fang wang zhan
观光	guan guang
关怀	guan huai
关机	guan ji
关键	guan jian
关键词	guan jian ci
关键是	guan jian shi
关键字	guan jian zi
关节	guan jie
冠军	guan jun
观看	guan kan
管理	guan li
管理办法	guan li ban fa
管理部	guan li bu
管理部门	guan li bu men
管理层	guan li ceng
管理处	guan li chu
管理费	guan li fei
管理工作	guan li gong zuo
管理规定	guan li gui ding
管理机构	guan li ji gou
管理局	guan li ju
管理类	guan li lei
管理模式	guan li mo shi
管理人	guan li ren
管理人员	guan li ren yuan
管理软件	guan li ruan jian
管理水平	guan li shui ping
管理体系	guan li ti xi
管理体制	guan li ti zhi
管理条例	guan li tiao li
管理系统	guan li xi tong
管理学	guan li xue
管理员	guan li yuan
管理者	guan li zhe
管理制度	guan li zhi du
管理中心	guan li zhong xin
关联	guan lian
观念	guan nian
观赏	guan shang
灌水	guan shui
关税	guan shui
管委会	guan wei hui
关系	guan xi
关系到	guan xi dao
管辖	guan xia
管线	guan xian
关心	guan xin
关心的	guan xin de
关于	guan yu
关于加强	guan yu jia qiang
官员	guan yuan
管制	guan zhi
观众	guan zhong
关注	guan zhu
广播	guang bo
广播电视	guang bo dian shi
光彩	guang cai
广场	guang chang
广大	guang da
光电	guang dian
广东	guang dong
广东省	guang dong sheng
广泛	guang fan
广泛的	guang fan de
广告	guang gao
广告服务	guang gao fu wu
广告公司	guang gao gong si
广告位	guang gao wei
光滑	guang hua
光辉	guang hui
广阔	guang kuo
光临	guang lin
光芒	guang mang
光明	guang ming
光盘	guang pan
光驱	guang qu
光圈	guang quan
光荣	guang rong
广西	guang xi
光线	guang xian
光纤	guang xian
光学	guang xue
光源	guang yuan
光泽	guang ze
广州	guang zhou
广州市	guang zhou shi
贵宾	gui bin
规程	gui cheng
归档	gui dang
轨道	gui dao
规定	gui ding
规定了	gui ding le
规范	gui fan
规范化	gui fan hua
规范性	gui fan xing
规格	gui ge
贵公司	gui gong si
规划	gui hua
归还	gui huan
规矩	gui ju
归来	gui lai
桂林	gui lin
规律	gui lv
规模	gui mo
规模最大	gui mo zui da
归纳	gui na
归属	gui shu
柜台	gui tai
贵阳	gui yang
规则	gui ze
规章	gui zhang
规章制度	gui zhang zhi du
贵州	gui zhou
贵州省	gui zhou sheng
贵族	gui zu
滚动	gun dong
国产	guo chan
国产软件	guo chan ruan jian
过程	guo cheng
过程中	guo cheng zhong
过程中的	guo cheng zhong de
过错	guo cuo
过大	guo da
国道	guo dao
过的	guo de
过度	guo du
过渡	guo du
过多	guo duo
国防	guo fang
过分	guo fen
过高	guo gao
过后	guo hou
国际	guo ji
国际标准	guo ji biao zhun
国际化	guo ji hua
国际贸易	guo ji mao yi
国际上	guo ji shang
国际市场	guo ji shi chang
国家	guo jia
国家安全	guo jia an quan
国家标准	guo jia biao zhun
国家法律	guo jia fa lv
国家规定	guo jia gui ding
国家级	guo jia ji
国家机关	guo jia ji guan
国家主席	guo jia zhu xi
过客	guo ke
过来	guo lai
过了	guo le
锅炉	guo lu
过滤	guo lv
国民	guo min
过敏	guo min
国民党	guo min dang
国民经济	guo min jing ji
国内	guo nei
国内市场	guo nei shi chang
国内外	guo nei wai
过期	guo qi
国庆	guo qing
国情	guo qing
过去	guo qu
过去了	guo qu le
果然	guo ran
国人	guo ren
果实	guo shi
国土	guo tu
国土资源	guo tu zi yuan
国外	guo wai
国王	guo wang
国务院	guo wu yuan
国有	guo you
国有股	guo you gu
国有企业	guo you qi ye
国有资产	guo you zi chan
过于	guo yu
国语	guo yu
国债	guo zhai
哈尔滨	ha er bin
哈尔滨市	ha er bin shi
海拔	hai ba
海报	hai bao
还包括	hai bao kuo
还必须	hai bi xu
还不	hai bu
还不错	hai bu cuo
还不如	hai bu ru
还不是	hai bu shi
还得	hai dei
海淀区	hai dian qu
海尔	hai er
海关	hai guan
还好	hai hao
还很	hai hen
还会	hai hui
还将	hai jiang
海军	hai jun
还可	hai ke
还可以	hai ke yi
海口	hai kou
还买	hai mai
还没	hai mei
还没有	hai mei you
海南	hai nan
海内外	hai nei wai
还能	hai neng
害怕	hai pa
海上	hai shang
还是	hai shi
还是很	hai shi hen
还是要	hai shi yao
还是有	hai shi you
还是在	hai shi zai
海水	hai shui
还说	hai shuo
海外	hai wai
还未	hai wei
还为	hai wei
海鲜	hai xian
还需	hai xu
还需要	hai xu yao
海洋	hai yang
还要	hai yao
还应	hai ying
还有	hai you
还有很多	hai you hen duo
还有什么	hai you shen me
还有一个	hai you yi ge
还有一些	hai you yi xie
海域	hai yu
还在	hai zai
还真	hai zhen
孩子	hai zi
孩子们	hai zi men
涵盖	han gai
韩国	han guo
汉化	han hua
焊接	han jie
寒冷	han leng
含量	han liang
函数	han shu
含意	han yi
含有	han you
汉语	han yu
汉字	han zi
汉族	han zu
航班	hang ban
航空	hang kong
航空公司	hang kong gong si
行列	hang lie
行情	hang qing
航天	hang tian
航线	hang xian
行业	hang ye
行业标准	hang ye biao zhun
行业发展	hang ye fa zhan
行业协会	hang ye xie hui
杭州	hang zhou
杭州市	hang zhou shi
好啊	hao a
好吧	hao ba
毫不	hao bu
好不好	hao bu hao
耗材	hao cai
号称	hao cheng
好吃	hao chi
好处	hao chu
好的	hao de
好东西	hao dong xi
好多	hao duo
豪华	hao hua
好坏	hao huai
好看	hao kan
毫克	hao ke
好莱坞	hao lai wu
好了	hao le
好吗	hao ma
毫米	hao mi
毫秒	hao miao
好朋友	hao peng you
好评	hao ping
好评度	hao ping du
好奇	hao qi
好人	hao ren
毫升	hao sheng
好事	hao shi
好玩	hao wan
毫无	hao wu
好像	hao xiang
好友	hao you
好在	hao zai
号召	hao zhao
河北	he bei
河北省	he bei sheng
何必	he bi
合并	he bing
核查	he cha
合成	he cheng
何处	he chu
河道	he dao
核定	he ding
核对	he dui
合法	he fa
核发	he fa
合法权益	he fa quan yi
合法性	he fa xing
合肥	he fei
合肥市	he fei shi
合格	he ge
呵护	he hu
合伙人	he huo ren
合金	he jin
喝酒	he jiu
何况	he kuang
荷兰	he lan
喝了	he le
合理	he li
合力	he li
合理的	he li de
河流	he liu
河南	he nan
河南省	he nan sheng
和你	he ni
和平	he ping
和尚	he shang
合适	he shi
核实	he shi
何时	he shi
和他	he ta
和她	he ta
核桃	he tao
合同	he tong
合同样本	he tong yang ben
合同约定	he tong yue ding
和我	he wo
和弦	he xian
和相关	he xiang guan
和谐	he xie
和谐社会	he xie she hui
核心	he xin
合约	he yue
何种	he zhong
核准	he zhun
合资	he zi
合租	he zu
合作	he zuo
合作关系	he zuo guan xi
合作伙伴	he zuo huo ban
黑暗	hei an
黑白	hei bai
黑客	hei ke
黑龙江	hei long jiang
黑龙江省	hei long jiang sheng
黑色	hei se
很不错	hen bu cuo
很长	hen chang
很大	hen da
很大啊	hen da a
很低	hen di
很多	hen duo
很多人	hen duo ren
很高	hen gao
很高兴	hen gao xing
很好	hen hao
痕迹	hen ji
很简单	hen jian dan
很久	hen jiu
很可能	hen ke neng
很快	hen kuai
很明显	hen ming xian
很难	hen nan
很强	hen qiang
很容易	hen rong yi
很少	hen shao
很是	hen shi
很喜欢	hen xi huan
很想	hen xiang
很小	hen xiao
很有	hen you
很重	hen zhong
很重要	hen zhong yao
衡量	heng liang
横向	heng xiang
红包	hong bao
宏观	hong guan
宏观调控	hong guan tiao kong
红军	hong jun
红楼梦	hong lou meng
红旗	hong qi
红色	hong se
红柿	hong shi
洪水	hong shui
红外	hong wai
弘扬	hong yang
厚度	hou du
后方	hou fang
后果	hou guo
后悔	hou hui
后会	hou hui
后将	hou jiang
后来	hou lai
后面	hou mian
后期	hou qi
后勤	hou qin
后人	hou ren
后台	hou tai
后续	hou xu
候选	hou xuan
候选人	hou xuan ren
后由	hou you
后又	hou you
后者	hou zhe
猴子	hou zi
湖北	hu bei
湖北省	hu bei sheng
蝴蝶	hu die
互动	hu dong
呼唤	hu huan
户籍	hu ji
呼叫	hu jiao
胡锦涛	hu jin tao
户口	hu kou
护理	hu li
狐狸	hu li
互联	hu lian
互联网	hu lian wang
忽略	hu lve
户名	hu ming
湖南	hu nan
湖南省	hu nan sheng
湖泊	hu po
忽然	hu ran
护士	hu shi
忽视	hu shi
户外	hu wai
呼吸	hu xi
互相	hu xiang
户型	hu xing
呼吁	hu yu
护照	hu zhao
互助	hu zhu
华北	hua bei
画的	hua de
画得	hua de
华东	hua dong
花朵	hua duo
花费	hua fei
化肥	hua fei
划分	hua fen
化工	hua gong
花卉	hua hui
画家	hua jia
化解	hua jie
花了	hua le
华丽	hua li
画面	hua mian
华南	hua nan
花钱	hua qian
华人	hua ren
花生	hua sheng
话说	hua shuo
华硕	hua shuo
话题	hua ti
化为	hua wei
华夏	hua xia
化学	hua xue
滑雪	hua xue
化学品	hua xue pin
话语	hua yu
花园	hua yuan
化妆	hua zhuang
化妆品	hua zhuang pin
坏了	huai le
怀里	huai li
怀念	huai nian
怀疑	huai yi
怀孕	huai yun
环保	huan bao
换成	huan cheng
缓存	huan cun
环节	huan jie
缓解	huan jie
环境	huan jing
环境保护	huan jing bao hu
环境污染	huan jing wu ran
还款	huan kuan
欢乐	huan le
换了	huan le
缓慢	huan man
环球	huan qiu
欢喜	huan xi
幻想	huan xiang
欢迎	huan ying
幻影	huan ying
欢迎大家	huan ying da jia
欢迎光临	huan ying guang lin
欢迎您	huan ying nin
患有	huan you
还原	huan yuan
患者	huan zhe
皇帝	huang di
黄豆	huang dou
黄蜂	huang feng
黄河	huang he
皇后	huang hou
黄昏	huang hun
皇家	huang jia
黄金	huang jin
黄金周	huang jin zhou
黄色	huang se
皇上	huang shang
黄页	huang ye
会把	hui ba
汇报	hui bao
回报	hui bao
会被	hui bei
回避	hui bi
会比	hui bi
会不会	hui bu hui
会场	hui chang
灰尘	hui chen
会出现	hui chu xian
回答	hui da
回到	hui dao
回到了	hui dao le
会的	hui de
回复	hui fu
恢复	hui fu
回复日期	hui fu ri qi
会给	hui gei
会更	hui geng
回顾	hui gu
回归	hui gui
回国	hui guo
会很	hui hen
辉煌	hui huang
回家	hui jia
会将	hui jiang
汇款	hui kuan
回来	hui lai
回来的	hui lai de
回来了	hui lai le
贿赂	hui lu
回落	hui luo
汇率	hui lv
毁灭	hui mie
惠普	hui pu
回去	hui qu
会去	hui qu
会让	hui rang
灰色	hui se
会上	hui shang
会使	hui shi
会是	hui shi
回收	hui shou
会说	hui shuo
回帖	hui tie
会同	hui tong
回头	hui tou
会议	hui yi
回忆	hui yi
会议上	hui yi shang
会议室	hui yi shi
回应	hui ying
会影响	hui ying xiang
会有	hui you
会员	hui yuan
会员价	hui yuan jia
会在	hui zai
会展	hui zhan
会长	hui zhang
绘制	hui zhi
惠州	hui zhou
汇总	hui zong
混合	hun he
婚礼	hun li
混乱	hun luan
混凝土	hun ning tu
浑身	hun shen
婚姻	hun yin
伙伴	huo ban
货币	huo bi
火车	huo che
火车站	huo che zhan
货到付款	huo dao fu kuan
获得了	huo de le
活动	huo dong
活动中	huo dong zhong
火锅	huo guo
火箭	huo jian
获奖	huo jiang
货款	huo kuan
活力	huo li
获利	huo li
活泼	huo po
或其	huo qi
或其他	huo qi ta
获取	huo qu
或是	huo shi
货物	huo wu
获悉	huo xi
活性	huo xing
火星	huo xing
或许	huo xu
火焰	huo yan
或以	huo yi
或有	huo you
活跃	huo yue
货运	huo yun
火灾	huo zai
或在	huo zai
或者	huo zhe
或者其他	huo zhe qi ta
或者是	huo zhe shi
或者说	huo zhe shuo
几百	ji bai
基本	ji ben
基本情况	ji ben qing kuang
基本上	ji ben shang
基本信息	ji ben xin xi
基本要求	ji ben yao qiu
基本原则	ji ben yuan ze
即便	ji bian
级别	ji bie
疾病	ji bing
疾病的	ji bing de
既不	ji bu
基层	ji ceng
机场	ji chang
集成	ji cheng
继承	ji cheng
集成电路	ji cheng dian lu
基础	ji chu
基础教育	ji chu jiao yu
基础上	ji chu shang
基础设施	ji chu she shi
基础知识	ji chu zhi shi
机床	ji chuang
几次	ji ci
极大	ji da
极大的	ji da de
鸡蛋	ji dan
记得	ji de
基地	ji di
几点	ji dian
激动	ji dong
机动	ji dong
机动车	ji dong che
极度	ji du
季度	ji du
极端	ji duan
激发	ji fa
机房	ji fang
计费	ji fei
积分	ji fen
几分	ji fen
肌肤	ji fu
几个	ji ge
几个方面	ji ge fang mian
几个人	ji ge ren
几个月	ji ge yue
机构	ji gou
机关	ji guan
激光	ji guang
集合	ji he
几何	ji he
几乎	ji hu
几乎没有	ji hu mei you
几乎是	ji hu shi
几乎所有	ji hu suo you
计划	ji hua
计划生育	ji hua sheng yu
机会	ji hui
激活	ji huo
积极	ji ji
积极参与	ji ji can yu
积极的	ji ji de
积极地	ji ji de
积极开展	ji ji kai zhan
积极探索	ji ji tan suo
积极性	ji ji xing
几家	ji jia
即将	ji jiang
季节	ji jie
基金	ji jin
基金会	ji jin hui
极具	ji ju
几句	ji ju
即可	ji ke
既可	ji ke
积累	ji lei
积累了	ji lei le
激励	ji li
剂量	ji liang
激烈	ji lie
吉林	ji lin
吉林省	ji lin sheng
记录	ji lu
纪录	ji lu
纪律	ji lv
几率	ji lv
急忙	ji mang
寂寞	ji mo
济南	ji nan
济南市	ji nan shi
技能	ji neng
机能	ji neng
几年	ji nian
纪念	ji nian
机票	ji piao
极品	ji pin
极其	ji qi
及其	ji qi
机器	ji qi
机器人	ji qi ren
及其他	ji qi ta
技巧	ji qiao
激情	ji qing
既然	ji ran
肌肉	ji rou
计入	ji ru
机上	ji shang
机身	ji shen
及时	ji shi
即使	ji shi
既是	ji shi
几十	ji shi
几十年	ji shi nian
即使是	ji shi shi
技术	ji shu
技术标准	ji shu biao zhun
技术创新	ji shu chuang xin
技术服务	ji shu fu wu
技术开发	ji shu kai fa
技术人员	ji shu ren yuan
技术水平	ji shu shui ping
技术与	ji shu yu
技术支持	ji shu zhi chi
祭祀	ji si
激素	ji su
计算	ji suan
计算机	ji suan ji
计算机的	ji suan ji de
吉他	ji ta
集体	ji ti
机体	ji ti
几天	ji tian
集团	ji tuan
集团公司	ji tuan gong si
极为	ji wei
几位	ji wei
即为	ji wei
纪委	ji wei
极限	ji xian
吉祥	ji xiang
机箱	ji xiang
迹象	ji xiang
绩效	ji xiao
讥笑	ji xiao
机械	ji xie
机械设备	ji xie she bei
记性	ji xing
机型	ji xing
急性	ji xing
畸形	ji xing
继续	ji xu
急须	ji xu
急需	ji xu
继续教育	ji xu jiao yu
既要	ji yao
记忆	ji yi
基因	ji yin
既有	ji you
给予	ji yu
基于	ji yu
机遇	ji yu
给予警告	ji yu jing gao
记载	ji zai
即在	ji zai
记者	ji zhe
机制	ji zhi
集中	ji zhong
几种	ji zhong
集中在	ji zhong zai
记住	ji zhu
集装箱	ji zhuang xiang
机组	ji zu
加班	jia ban
嘉宾	jia bin
家产	jia chan
加大	jia da
加大了	jia da le
家电	jia dian
甲方	jia fang
加盖	jia gai
价格	jia ge
加工	jia gong
架构	jia gou
家和	jia he
家伙	jia huo
家教	jia jiao
家具	jia ju
家居	jia ju
加剧	jia ju
加快	jia kuai
加快发展	jia kuai fa zhan
价款	jia kuan
加了	jia le
家里	jia li
加盟	jia meng
加密	jia mi
加拿大	jia na da
佳能	jia neng
假期	jia qi
价钱	jia qian
加强	jia qiang
甲醛	jia quan
加热	jia re
家人	jia ren
假日	jia ri
加入	jia ru
假如	jia ru
加入时间	jia ru shi jian
加入收藏	jia ru shou cang
加上	jia shang
假设	jia she
加深	jia shen
驾驶	jia shi
驾驶员	jia shi yuan
驾驶证	jia shi zheng
家属	jia shu
加速	jia su
家庭	jia ting
价位	jia wei
加为	jia wei
家乡	jia xiang
驾校	jia xiao
家用	jia yong
家用电器	jia yong dian qi
加油	jia you
加油站	jia you zhan
家园	jia yuan
加载	jia zai
家长	jia zhang
价值	jia zhi
加之	jia zhi
价值观	jia zhi guan
家中	jia zhong
加重	jia zhong
家族	jia zu
肩膀	jian bang
简便	jian bian
鉴别	jian bie
兼并	jian bing
建材	jian cai
检测	jian ce
监测	jian ce
检查	jian cha
监察	jian cha
检察院	jian cha yuan
建成	jian cheng
简称	jian cheng
坚持	jian chi
简单	jian dan
见到	jian dao
鉴定	jian ding
坚定	jian ding
监督	jian du
监督管理	jian du guan li
监督检查	jian du jian cha
舰队	jian dui
减肥	jian fei
间隔	jian ge
监管	jian guan
见过	jian guo
建国	jian guo
见过吗	jian guo ma
简化	jian hua
简介	jian jie
间接	jian jie
简洁	jian jie
见解	jian jie
坚决	jian jue
健康	jian kang
健康发展	jian kang fa zhan
监控	jian kong
艰苦	jian ku
见了	jian le
建立	jian li
简历	jian li
建立了	jian li le
建立起	jian li qi
建立一个	jian li yi ge
建立在	jian li zai
见面	jian mian
减免	jian mian
艰难	jian nan
键盘	jian pan
坚强	jian qiang
减轻	jian qing
健全	jian quan
鉴权	jian quan
兼容	jian rong
减弱	jian ruo
减少	jian shao
减少了	jian shao le
建设	jian she
建设部	jian she bu
建设单位	jian she dan wei
建设工程	jian she gong cheng
建设工作	jian she gong zuo
建设项目	jian she xiang mu
建设用地	jian she yong di
建设中	jian she zhong
健身	jian shen
监视	jian shi
坚实的	jian shi de
检索	jian suo
见他	jian ta
简体中文	jian ti zhong wen
见习	jian xi
间隙	jian xi
减小	jian xiao
坚信	jian xin
检验	jian yan
简要	jian yao
建议	jian yi
简易	jian yi
监狱	jian yu
鉴于	jian yu
建造	jian zao
简直	jian zhi
建筑	jian zhu
建筑材料	jian zhu cai liao
建筑工程	jian zhu gong cheng
建筑面积	jian zhu mian ji
建筑物	jian zhu wu
建筑业	jian zhu ye
将被	jiang bei
将不	jiang bu
将成为	jiang cheng wei
将从	jiang cong
将达到	jiang da dao
降到	jiang dao
讲的	jiang de
降低	jiang di
降低了	jiang di le
将对	jiang dui
将该	jiang gai
江湖	jiang hu
讲话	jiang hua
将会	jiang hui
降价	jiang jia
讲解	jiang jie
奖金	jiang jin
将近	jiang jin
讲究	jiang jiu
将军	jiang jun
将来	jiang lai
讲了	jiang le
奖励	jiang li
江南	jiang nan
奖品	jiang pin
将其	jiang qi
将是	jiang shi
僵尸	jiang shi
讲授	jiang shou
讲述	jiang shu
江苏	jiang su
江苏省	jiang su sheng
将为	jiang wei
将我	jiang wo
江西	jiang xi
江西省	jiang xi sheng
奖项	jiang xiang
奖学金	jiang xue jin
将要	jiang yao
将以	jiang yi
将有	jiang you
酱油	jiang you
将由	jiang you
将于	jiang yu
将在	jiang zai
江泽民	jiang ze min
将这	jiang zhe
讲座	jiang zuo
教案	jiao an
骄傲	jiao ao
搅拌	jiao ban
脚本	jiao ben
脚步	jiao bu
教材	jiao cai
交叉	jiao cha
较差	jiao cha
较长	jiao chang
轿车	jiao che
教程	jiao cheng
较大	jiao da
较大的	jiao da de
叫道	jiao dao
较低	jiao di
焦点	jiao dian
角度	jiao du
较多	jiao duo
较多的	jiao duo de
缴费	jiao fei
交付	jiao fu
较高	jiao gao
较高的	jiao gao de
交给	jiao gei
较好	jiao hao
较好的	jiao hao de
交互	jiao hu
交换	jiao huan
交换机	jiao huan ji
教会	jiao hui
交货	jiao huo
较快	jiao kuai
教练	jiao lian
交流	jiao liu
角落	jiao luo
焦虑	jiao lv
缴纳	jiao na
交纳	jiao na
胶囊	jiao nang
较强	jiao qiang
郊区	jiao qu
较少	jiao shao
叫声	jiao sheng
教师	jiao shi
教室	jiao shi
教授	jiao shou
交谈	jiao tan
教堂	jiao tang
交通	jiao tong
交通便利	jiao tong bian li
交通管理	jiao tong guan li
交通事故	jiao tong shi gu
交通运输	jiao tong yun shu
交往	jiao wang
较为	jiao wei
叫我	jiao wo
脚下	jiao xia
较小	jiao xiao
教学	jiao xue
教学方法	jiao xue fang fa
教学内容	jiao xue nei rong
教学质量	jiao xue zhi liang
教训	jiao xun
教研室	jiao yan shi
交易	jiao yi
交易所	jiao yi suo
交友	jiao you
教育	jiao yu
教育部	jiao yu bu
教育工作	jiao yu gong zuo
教育活动	jiao yu huo dong
教育教学	jiao yu jiao xue
教育局	jiao yu ju
教育培训	jiao yu pei xun
教育事业	jiao yu shi ye
教育厅	jiao yu ting
教职工	jiao zhi gong
较重	jiao zhong
叫作	jiao zuo
阶层	jie ceng
接触	jie chu
解除	jie chu
解答	jie da
接待	jie dai
街道	jie dao
接到	jie dao
节点	jie dian
界定	jie ding
解读	jie du
阶段	jie duan
阶段的	jie duan de
解放	jie fang
解放军	jie fang jun
结构	jie gou
结构调整	jie gou tiao zheng
接管	jie guan
接轨	jie gui
结果	jie guo
接过	jie guo
结果是	jie guo shi
结合	jie he
结合起来	jie he qi lai
结婚	jie hun
阶级	jie ji
节假日	jie jia ri
借鉴	jie jian
接近	jie jin
结局	jie ju
解决	jie jue
解决方案	jie jue fang an
解决方法	jie jue fang fa
解决了	jie jue le
解决问题	jie jue wen ti
接口	jie kou
借口	jie kou
借款	jie kuan
结论	jie lun
姐妹	jie mei
界面	jie mian
节目	jie mu
节能	jie neng
节日	jie ri
接入	jie ru
介入	jie ru
街上	jie shang
介绍	jie shao
介绍了	jie shao le
介绍说	jie shao shuo
节省	jie sheng
解释	jie shi
届时	jie shi
揭示	jie shi
接受	jie shou
接收	jie shou
接收了	jie shou le
接受了	jie shou le
结束	jie shu
结束后	jie shu hou
结束了	jie shu le
节水	jie shui
解说	jie shuo
结算	jie suan
街头	jie tou
解脱	jie tuo
结尾	jie wei
解析	jie xi
接下	jie xia
接下来	jie xia lai
界限	jie xian
解压	jie ya
解压密码	jie ya mi ma
节约	jie yue
接着	jie zhe
戒指	jie zhi
截止	jie zhi
截至	jie zhi
节制	jie zhi
借助	jie zhu
节奏	jie zou
金币	jin bi
进步	jin bu
进程	jin cheng
进出口	jin chu kou
近代	jin dai
仅代表	jin dai biao
金的	jin de
进度	jin du
金额	jin e
进而	jin er
金刚	jin gang
进攻	jin gong
仅供	jin gong
仅供参考	jin gong can kao
尽管	jin guan
今后	jin hou
进化	jin hua
进货	jin huo
紧急	jin ji
近几年	jin ji nian
进军	jin jun
进口	jin kou
尽快	jin kuai
进来	jin lai
近来	jin lai
进了	jin le
尽力	jin li
尽量	jin liang
紧密	jin mi
紧密结合	jin mi jie he
仅能	jin neng
今年	jin nian
近年	jin nian
近年来	jin nian lai
今年以来	jin nian yi lai
金牌	jin pai
浸泡	jin pao
近期	jin qi
金钱	jin qian
尽情	jin qing
进球	jin qiu
进去	jin qu
金融	jin rong
金融机构	jin rong ji gou
进入	jin ru
进入了	jin ru le
进入中国	jin ru zhong guo
金色	jin se
金山	jin shan
谨慎	jin shen
晋升	jin sheng
仅是	jin shi
金属	jin shu
今天	jin tian
今天是	jin tian shi
津贴	jin tie
今晚	jin wan
仅为	jin wei
进行	jin xing
进行分析	jin xing fen xi
进行检查	jin xing jian cha
进行了	jin xing le
进修	jin xiu
进一步	jin yi bu
进一步的	jin yi bu de
禁用	jin yong
仅有	jin you
仅在	jin zai
尽在	jin zai
进展	jin zhan
紧张	jin zhang
紧张的	jin zhang de
禁止	jin zhi
精彩	jing cai
精彩的	jing cai de
警察	jing cha
经常	jing chang
京城	jing cheng
经典	jing dian
景点	jing dian
精度	jing du
警方	jing fang
经费	jing fei
警告	jing gao
景观	jing guan
经过	jing guo
经过了	jing guo le
精华	jing hua
净化	jing hua
经济	jing ji
经济法	jing ji fa
经济发展	jing ji fa zhan
经济建设	jing ji jian she
经纪人	jing ji ren
经济社会	jing ji she hui
经济效益	jing ji xiao yi
经济学	jing ji xue
经济增长	jing ji zeng zhang
竞价	jing jia
境界	jing jie
经理	jing li
经历	jing li
精力	jing li
经历了	jing li le
经理人	jing li ren
净利润	jing li run
精灵	jing ling
经贸	jing mao
精美	jing mei
精密	jing mi
境内	jing nei
精品	jing pin
敬请	jing qing
景区	jing qu
精确	jing que
竟然	jing ran
惊人	jing ren
惊人的	jing ren de
竞赛	jing sai
景色	jing se
精神	jing shen
竟是	jing shi
警示	jing shi
精髓	jing sui
静态	jing tai
警惕	jing ti
精通	jing tong
镜头	jing tou
境外	jing wai
惊喜	jing xi
精细	jing xi
镜像	jing xiang
景象	jing xiang
经销	jing xiao
经销商	jing xiao shang
精心	jing xin
精选	jing xuan
惊讶	jing ya
经验	jing yan
经验值	jing yan zhi
敬业	jing ye
经营	jing ying
精英	jing ying
经营的	jing ying de
经营范围	jing ying fan wei
经营管理	jing ying guan li
经营活动	jing ying huo dong
经营理念	jing ying li nian
经营模式	jing ying mo shi
经营权	jing ying quan
经营性	jing ying xing
经营者	jing ying zhe
竞争	jing zheng
竞争的	jing zheng de
竞争对手	jing zheng dui shou
竞争力	jing zheng li
竞争中	jing zheng zhong
精致	jing zhi
镜子	jing zi
精子	jing zi
就把	jiu ba
就被	jiu bei
就必须	jiu bi xu
就不	jiu bu
就不会	jiu bu hui
就不能	jiu bu neng
就成了	jiu cheng le
就此	jiu ci
就得	jiu dei
酒店	jiu dian
就读	jiu du
纠纷	jiu fen
就更	jiu geng
就好	jiu hao
就好了	jiu hao le
就很	jiu hen
就会	jiu hui
就将	jiu jiang
就叫	jiu jiao
究竟	jiu jing
酒精	jiu jing
究竟是	jiu jing shi
就开始	jiu kai shi
就看	jiu kan
就可	jiu ke
就可以	jiu ke yi
就可以了	jiu ke yi le
就来	jiu lai
就连	jiu lian
就没	jiu mei
就没有	jiu mei you
就能	jiu neng
就去	jiu qu
就让	jiu rang
就是	jiu shi
就是说	jiu shi shuo
就是我	jiu shi wo
就是要	jiu shi yao
就是在	jiu shi zai
就是这样	jiu shi zhe yang
就说	jiu shuo
就算	jiu suan
九五	jiu wu
就像	jiu xiang
就想	jiu xiang
就行	jiu xing
就行了	jiu xing le
就要	jiu yao
就业	jiu ye
就已经	jiu yi jing
就应该	jiu ying gai
就用	jiu yong
就有	jiu you
救援	jiu yuan
九月	jiu yue
就越	jiu yue
就在	jiu zai
就在于	jiu zai yu
就这么	jiu zhe me
就这样	jiu zhe yang
纠正	jiu zheng
就知道	jiu zhi dao
救助	jiu zhu
举办	ju ban
举办了	ju ban le
举报	ju bao
具备	ju bei
具备了	ju bei le
剧本	ju ben
局部	ju bu
剧场	ju chang
据此	ju ci
举措	ju cuo
巨大	ju da
巨大的	ju da de
举动	ju dong
聚会	ju hui
聚集	ju ji
聚焦	ju jiao
据介绍	ju jie shao
拒绝	ju jue
俱乐部	ju le bu
距离	ju li
据了解	ju liao jie
局面	ju mian
居民	ju min
剧情	ju qing
居然	ju ran
据说	ju shuo
具体	ju ti
具体情况	ju ti qing kuang
具体要求	ju ti yao qiu
据统计	ju tong ji
巨头	ju tou
据悉	ju xi
举行	ju xing
举行了	ju xing le
具有	ju you
局域网	ju yu wang
局长	ju zhang
居住	ju zhu
句子	ju zi
捐款	juan kuan
捐赠	juan zeng
决策	jue ce
绝大部分	jue da bu fen
绝大多数	jue da duo shu
觉得	jue de
决定	jue ding
决定了	jue ding le
绝对	jue dui
绝对不	jue dui bu
绝对是	jue dui shi
崛起	jue qi
决赛	jue sai
角色	jue se
绝望	jue wang
决心	jue xin
决议	jue yi
绝缘	jue yuan
均不	jun bu
军队	jun dui
竣工	jun gong
军官	jun guan
均衡	jun heng
均价	jun jia
均可	jun ke
军人	jun ren
军事	jun shi
均是	jun shi
均属	jun shu
军团	jun tuan
均为	jun wei
均有	jun you
均由	jun you
均匀	jun yun
君子	jun zi
卡的	ka de
咖啡	ka fei
卡号	ka hao
卡里	ka li
卡片	ka pian
卡通	ka tong
开办	kai ban
开本	kai ben
开采	kai cai
开车	kai che
开出	kai chu
开创	kai chuang
开的	kai de
开店	kai dian
开发	kai fa
开发利用	kai fa li yong
开发区	kai fa qu
开发商	kai fa shang
开发者	kai fa zhe
开放	kai fang
开工	kai gong
开关	kai guan
开户	kai hu
开会	kai hui
开机	kai ji
开具	kai ju
开口	kai kou
开来	kai lai
开了	kai le
开门	kai men
开幕	kai mu
开幕式	kai mu shi
开盘	kai pan
开辟	kai pi
开启	kai qi
开设	kai she
开始	kai shi
开始了	kai shi le
开通	kai tong
开头	kai tou
开拓	kai tuo
开拓创新	kai tuo chuang xin
开心	kai xin
开业	kai ye
开展	kai zhan
开展工作	kai zhan gong zuo
开展了	kai zhan le
开支	kai zhi
看不到	kan bu dao
堪称	kan cheng
看出	kan chu
看待	kan dai
看到	kan dao
看到了	kan dao le
看的	kan de
看得	kan de
刊登	kan deng
看法	kan fa
看过	kan guo
看好	kan hao
看见	kan jian
看来	kan lai
看了	kan le
看了看	kan le kan
看你	kan ni
看起来	kan qi lai
看上去	kan shang qu
看书	kan shu
看似	kan si
看他	kan ta
看她	kan ta
看完	kan wan
看我	kan wo
刊物	kan wu
看着	kan zhe
看着他	kan zhe ta
看着我	kan zhe wo
看作	kan zuo
康复	kang fu
慷慨	kang kai
抗日	kang ri
抗生素	kang sheng su
抗体	kang ti
康熙	kang xi
拷贝	kao bei
考场	kao chang
考点	kao dian
考古	kao gu
考核	kao he
靠近	kao jin
考虑	kao lv
考虑到	kao lv dao
考评	kao ping
考前	kao qian
烤肉	kao rou
考生	kao sheng
考试	kao shi
考试成绩	kao shi cheng ji
考验	kao yan
考研	kao yan
考证	kao zheng
可爱	ke ai
可按	ke an
课本	ke ben
可不	ke bu
客车	ke che
课程	ke cheng
可达	ke da
客房	ke fang
可分为	ke fen wei
客服	ke fu
克服	ke fu
客服电话	ke fu dian hua
客服热线	ke fu re xian
可根据	ke gen ju
可供	ke gong
客观	ke guan
客户	ke hu
客户端	ke hu duan
客户服务	ke hu fu wu
科技	ke ji
科技成果	ke ji cheng guo
科技创新	ke ji chuang xin
科技进步	ke ji jin bu
可见	ke jian
课件	ke jian
可将	ke jiang
可就	ke jiu
可靠	ke kao
可靠的	ke kao de
可靠性	ke kao xing
可口可乐	ke kou ke le
可乐	ke le
颗粒	ke li
可怜	ke lian
克隆	ke long
刻录	ke lu
科目	ke mu
可能	ke neng
可能的	ke neng de
可能会	ke neng hui
可能是	ke neng shi
可能性	ke neng xing
可能因	ke neng yin
可能有	ke neng you
可能在	ke neng zai
可怕	ke pa
科普	ke pu
客人	ke ren
客商	ke shang
可是	ke shi
课时	ke shi
可使	ke shi
科室	ke shi
可是我	ke shi wo
咳嗽	ke sou
课堂	ke tang
课堂教学	ke tang jiao xue
课题	ke ti
可调	ke tiao
客厅	ke ting
可通过	ke tong guo
渴望	ke wang
可为	ke wei
可谓	ke wei
课文	ke wen
可我	ke wo
可惜	ke xi
可向	ke xiang
可行	ke xing
可行性	ke xing xing
可选	ke xuan
可选择	ke xuan ze
科学	ke xue
科学技术	ke xue ji shu
科学家	ke xue jia
科学研究	ke xue yan jiu
科学院	ke xue yuan
科研	ke yan
可以	ke yi
刻意	ke yi
可以把	ke yi ba
可以从	ke yi cong
可以根据	ke yi gen ju
可以看出	ke yi kan chu
可以看到	ke yi kan dao
可以去	ke yi qu
可以让	ke yi rang
可以使	ke yi shi
可以实现	ke yi shi xian
可以使用	ke yi shi yong
可以说	ke yi shuo
可以说是	ke yi shuo shi
可以通过	ke yi tong guo
可以向	ke yi xiang
可以选择	ke yi xuan ze
可以用	ke yi yong
可以直接	ke yi zhi jie
可用	ke yong
可用于	ke yong yu
可由	ke you
可与	ke yu
客运	ke yun
可在	ke zai
可直接	ke zhi jie
可作	ke zuo
肯定	ken ding
肯定会	ken ding hui
肯定是	ken ding shi
空白	kong bai
恐怖	kong bu
空格	kong ge
控股	kong gu
空间	kong jian
控件	kong jian
恐惧	kong ju
空军	kong jun
恐怕	kong pa
空气	kong qi
空前	kong qian
空调	kong tiao
控制	kong zhi
控制面板	kong zhi mian ban
控制器	kong zhi qi
控制系统	kong zhi xi tong
控制在	kong zhi zai
空中	kong zhong
孔子	kong zi
口岸	kou an
口碑	kou bei
扣除	kou chu
口袋	kou dai
口服	kou fu
口号	kou hao
口令	kou ling
口气	kou qi
口腔	kou qiang
口头	kou tou
口味	kou wei
口语	kou yu
口中	kou zhong
库存	ku cun
哭了	ku le
哭泣	ku qi
苦笑	ku xiao
裤子	ku zi
跨国	kua guo
跨国公司	kua guo gong si
跨越	kua yue
夸张	kua zhang
快递	kuai di
快点	kuai dian
快感	kuai gan
会计	kuai ji
快捷	kuai jie
快乐	kuai le
快乐的	kuai le de
块钱	kuai qian
快速	kuai su
快速发展	kuai su fa zhan
快速回复	kuai su hui fu
快速增长	kuai su zeng zhang
宽带	kuan dai
宽度	kuan du
宽容	kuan rong
款式	kuan shi
款项	kuan xiang
矿产资源	kuang chan zi yuan
框架	kuang jia
况且	kuang qie
矿山	kuang shan
亏损	kui sun
捆绑	kun bang
困惑	kun huo
困境	kun jing
昆明	kun ming
困难	kun nan
困扰	kun rao
扩充	kuo chong
扩大	kuo da
扩建	kuo jian
扩散	kuo san
扩展	kuo zhan
扩张	kuo zhang
喇叭	la ba
拉动	la dong
垃圾	la ji
垃圾邮件	la ji you jian
辣椒	la jiao
拉开	la kai
拉萨	la sa
落下	la xia
落在	la zai
拉着	la zhe
蜡烛	la zhu
来吧	lai ba
来到	lai dao
来到了	lai dao le
来电	lai dian
来访	lai fang
来回	lai hui
来讲	lai jiang
来看	lai kan
来了	lai le
来临	lai lin
来实现	lai shi xian
来说	lai shuo
来完成	lai wan cheng
来信	lai xin
来源	lai yuan
来源于	lai yuan yu
来自	lai zi
来自于	lai zi yu
来做	lai zuo
栏目	lan mu
篮球	lan qiu
蓝色	lan se
蓝天	lan tian
蓝牙	lan ya
兰州	lan zhou
浪费	lang fei
浪漫	lang man
老百姓	lao bai xing
老板	lao ban
老大	lao da
劳动	lao dong
劳动保障	lao dong bao zhang
劳动关系	lao dong guan xi
劳动合同	lao dong he tong
劳动力	lao dong li
劳动者	lao dong zhe
老公	lao gong
牢固	lao gu
老虎	lao hu
老虎机	lao hu ji
老化	lao hua
牢记	lao ji
老家	lao jia
老年	lao nian
老年人	lao nian ren
老婆	lao po
老人	lao ren
老师	lao shi
老是	lao shi
老鼠	lao shu
老头	lao tou
劳务	lao wu
老子	lao zi
老总	lao zong
了吧	le ba
乐观	le guan
乐趣	le qu
乐园	le yuan
类别	lei bie
雷达	lei da
累计	lei ji
累积	lei ji
累了	lei le
泪水	lei shui
类似	lei si
类似的	lei si de
类似于	lei si yu
类型	lei xing
冷静	leng jing
冷漠	leng mo
冷却	leng que
冷笑	leng xiao
离不开	li bu kai
理财	li cai
立场	li chang
里程	li cheng
历程	li cheng
历代	li dai
锂电池	li dian chi
力度	li du
立法	li fa
立方米	li fang mi
厉害	li hai
离婚	li hun
立即	li ji
丽江	li jiang
理解	li jie
历经	li jing
离开	li kai
离开了	li kai le
立刻	li ke
理科	li ke
历来	li lai
力量	li liang
理论	li lun
利率	li lv
礼貌	li mao
厘米	li mi
里面	li mian
里面有	li mian you
黎明	li ming
理念	li nian
礼品	li pin
力气	li qi
力求	li qiu
离去	li qu
例如	li ru
利润	li run
历史	li shi
理事	li shi
历时	li shi
历史的	li shi de
理事会	li shi hui
历史上	li shi shang
历史文化	li shi wen hua
立体	li ti
例外	li wai
礼物	li wu
利息	li xi
离线	li xian
李先生	li xian sheng
理想	li xiang
立项	li xiang
理想的	li xiang de
理性	li xing
利益	li yi
礼仪	li yi
利用	li yong
理由	li you
利于	li yu
力争	li zheng
理智	li zhi
离职	li zhi
例子	li zi
立足	li zu
恋爱	lian ai
联邦	lian bang
联动	lian dong
联合	lian he
联合国	lian he guo
联合会	lian he hui
莲花	lian hua
廉价	lian jia
连接	lian jie
链接	lian jie
联络	lian luo
连忙	lian mang
联盟	lian meng
恋人	lian ren
联赛	lian sai
脸色	lian se
脸上	lian shang
联手	lian shou
连锁	lian suo
连锁店	lian suo dian
联通	lian tong
连同	lian tong
联网	lian wang
联系	lian xi
练习	lian xi
联系地址	lian xi di zhi
联系电话	lian xi dian hua
联系方式	lian xi fang shi
联系人	lian xi ren
联系我们	lian xi wo men
联想	lian xiang
连续	lian xu
炼油厂	lian you chang
连载	lian zai
两岸	liang an
两边	liang bian
两侧	liang ce
两次	liang ci
两大	liang da
量大	liang da
量的	liang de
两地	liang di
亮点	liang dian
两点	liang dian
亮度	liang du
两个	liang ge
两个方面	liang ge fang mian
两个人	liang ge ren
两个月	liang ge yue
两国	liang guo
良好	liang hao
良好的	liang hao de
量化	liang hua
两集	liang ji
两极	liang ji
两级	liang ji
两家	liang jia
两句	liang ju
两款	liang kuan
两类	liang lei
两名	liang ming
两年	liang nian
两人	liang ren
粮食	liang shi
两天	liang tian
两条	liang tiao
两位	liang wei
亮相	liang xiang
两项	liang xiang
良性	liang xing
粮油	liang you
两张	liang zhang
两者	liang zhe
两只	liang zhi
两种	liang zhong
疗程	liao cheng
疗法	liao fa
了解	liao jie
了解到	liao jie dao
辽宁	liao ning
辽宁省	liao ning sheng
聊天	liao tian
聊天室	liao tian shi
疗效	liao xiao
列表	lie biao
列车	lie che
列出	lie chu
猎人	lie ren
列入	lie ru
列为	lie wei
临床	lin chuang
临近	lin jin
邻居	lin ju
林肯	lin ken
林木	lin mu
临时	lin shi
磷酸	lin suan
林业	lin ye
零部件	ling bu jian
凌晨	ling chen
领导	ling dao
领导班子	ling dao ban zi
领导干部	ling dao gan bu
领导人	ling dao ren
领导下	ling dao xia
领导小组	ling dao xiao zu
领导者	ling dao zhe
领队	ling dui
灵感	ling gan
灵魂	ling hun
灵活	ling huo
灵活性	ling huo xing
零件	ling jian
另类	ling lei
领取	ling qu
令人	ling ren
铃声	ling sheng
零售	ling shou
零售价	ling shou jia
零售商	ling shou shang
聆听	ling ting
另外	ling wai
另外一个	ling wai yi ge
令我	ling wo
领先	ling xian
另行	ling xing
领袖	ling xiu
另一	ling yi
另一方面	ling yi fang mian
另一个	ling yi ge
另一种	ling yi zhong
另有	ling you
另有规定	ling you gui ding
领域	ling yu
刘备	liu bei
流畅	liu chang
流程	liu cheng
流出	liu chu
流传	liu chuan
流动	liu dong
流动性	liu dong xing
六个	liu ge
留给	liu gei
六合彩	liu he cai
浏览	liu lan
浏览次数	liu lan ci shu
浏览器	liu lan qi
流浪	liu lang
流泪	liu lei
流量	liu liang
流氓	liu mang
六年	liu nian
流入	liu ru
流失	liu shi
六十	liu shi
流水	liu shui
流通	liu tong
留下	liu xia
留下了	liu xia le
流行	liu xing
留学	liu xue
留学生	liu xue sheng
留言	liu yan
留言板	liu yan ban
留意	liu yi
流域	liu yu
六月	liu yue
留在	liu zai
流转	liu zhuan
垄断	long duan
龙头	long tou
龙头企业	long tou qi ye
隆重	long zhong
楼层	lou ceng
露出	lou chu
漏洞	lou dong
楼盘	lou pan
楼上	lou shang
楼市	lou shi
楼梯	lou ti
楼下	lou xia
楼主	lou zhu
路边	lu bian
露出	lu chu
路段	lu duan
路过	lu guo
路径	lu jing
陆军	lu jun
路口	lu kou
路面	lu mian
录取	lu qu
录入	lu ru
路上	lu shang
路线	lu xian
录像	lu xiang
陆续	lu xu
鲁迅	lu xun
录音	lu yin
录用	lu yong
路由	lu you
路由器	lu you qi
录制	lu zhi
伦敦	lun dun
轮回	lun hui
轮廓	lun kuo
伦理	lun li
论述	lun shu
轮胎	lun tai
论坛	lun tan
论坛版主	lun tan ban zhu
论文	lun wen
论证	lun zheng
萝卜	luo bo
落地	luo di
落后	luo hou
落户	luo hu
逻辑	luo ji
罗马	luo ma
落实	luo shi
落下	luo xia
洛阳	luo yang
落在	luo zai
绿茶	lv cha
绿地	lv di
旅馆	lv guan
铝合金	lv he jin
绿化	lv hua
旅客	lv ke
绿色	lv se
绿色食品	lv se shi pin
律师	lv shi
履行	lv xing
旅行	lv xing
旅行社	lv xing she
旅游	lv you
旅游局	lv you ju
旅游业	lv you ye
旅游者	lv you zhe
略有	lve you
麻烦	ma fan
马克思	ma ke si
马来西亚	ma lai xi ya
马路	ma lu
马上	ma shang
码头	ma tou
蚂蚁	ma yi
马自达	ma zi da
麻醉药品	ma zui yao pin
卖场	mai chang
卖出	mai chu
麦当劳	mai dang lao
买到	mai dao
买的	mai de
卖点	mai dian
买房	mai fang
买方	mai fang
卖方	mai fang
买家	mai jia
卖家	mai jia
买了	mai le
买卖	mai mai
买入	mai ru
漫长	man chang
满分	man fen
漫画	man hua
满脸	man lian
馒头	man tou
慢性	man xing
蔓延	man yan
满意	man yi
满意地	man yi de
满意的	man yi de
漫游	man you
满足	man zu
忙碌	mang lu
盲目	mang mu
毛病	mao bing
矛盾	mao dun
毛巾	mao jin
茅台	mao tai
冒险	mao xian
贸易	mao yi
毛泽东	mao ze dong
毛主席	mao zhu xi
帽子	mao zi
美白	mei bai
没办法	mei ban fa
每次	mei ci
没错	mei cuo
每当	mei dang
每个	mei ge
每个人	mei ge ren
每个月	mei ge yue
每股	mei gu
美观	mei guan
没关系	mei guan xi
玫瑰	mei gui
美国	mei guo
美国人	mei guo ren
美好	mei hao
美化	mei hua
梅花	mei hua
媒介	mei jie
美金	mei jin
美景	mei jing
美军	mei jun
煤矿	mei kuang
没了	mei le
美丽	mei li
魅力	mei li
美妙	mei miao
没内存	mei nei cun
没能	mei neng
每年	mei nian
美女	mei nv
煤气	mei qi
没人	mei ren
每人	mei ren
美人	mei ren
每日	mei ri
美容	mei rong
没什么	mei shen me
美食	mei shi
没事	mei shi
美术	mei shu
煤炭	mei tan
媒体	mei ti
每天	mei tian
每位	mei wei
美味	mei wei
没问题	mei wen ti
没想到	mei xiang dao
美学	mei xue
每页	mei ye
每一	mei yi
每一次	mei yi ci
每一个	mei yi ge
没一个	mei yi ge
每一个人	mei yi ge ren
每一位	mei yi wei
没有	mei you
没有底	mei you di
没有了	mei you le
没有人	mei you ren
没有什么	mei you shen me
没油水	mei you shui
没有一个	mei you yi ge
没有注册	mei you zhu ce
美元	mei yuan
每月	mei yue
每周	mei zhou
门窗	men chuang
门的	men de
门店	men dian
门户	men hu
门户网站	men hu wang zhan
门槛	men kan
门口	men kou
门派	men pai
门票	men piao
门前	men qian
门外	men wai
门诊	men zhen
蒙古	meng gu
梦幻	meng huan
梦见	meng jian
梦想	meng xiang
梦中	meng zhong
弥补	mi bu
密度	mi du
米饭	mi fan
密封	mi feng
密集	mi ji
米兰	mi lan
密码	mi ma
秘密	mi mi
迷你	mi ni
密切	mi qie
密切相关	mi qie xiang guan
秘书	mi shu
秘书长	mi shu zhang
面板	mian ban
面包	mian bao
面部	mian bu
免除	mian chu
面对	mian dui
免费	mian fei
免费版	mian fei ban
免费软件	mian fei ruan jian
免费提供	mian fei ti gong
免费下载	mian fei xia zai
免费注册	mian fei zhu ce
面粉	mian fen
棉花	mian hua
面积	mian ji
面孔	mian kong
面料	mian liao
面临	mian lin
面临着	mian lin zhe
面貌	mian mao
面膜	mian mo
面前	mian qian
勉强	mian qiang
面上	mian shang
面试	mian shi
面谈	mian tan
面向	mian xiang
面议	mian yi
免疫	mian yi
免责声明	mian ze sheng ming
免征	mian zheng
面值	mian zhi
面子	mian zi
描绘	miao hui
描述	miao shu
描写	miao xie
民办	min ban
敏感	min gan
民工	min gong
民国	min guo
民航	min hang
民间	min jian
敏捷	min jie
民警	min jing
民生	min sheng
民事	min shi
民俗	min su
民营	min ying
民营企业	min ying qi ye
民用	min yong
民众	min zhong
民主	min zhu
民族	min zu
明白	ming bai
明白了	ming bai le
名称	ming cheng
名词	ming ci
明代	ming dai
名单	ming dan
明的	ming de
名额	ming e
名家	ming jia
名叫	ming jiao
明亮	ming liang
明了	ming liao
命令	ming ling
名录	ming lu
命名为	ming ming wei
明年	ming nian
名牌	ming pai
名片	ming pian
明确	ming que
明确的	ming que de
明确规定	ming que gui ding
名人	ming ren
名胜区	ming sheng qu
名师	ming shi
命题	ming ti
明天	ming tian
名为	ming wei
明显	ming xian
明显的	ming xian de
明星	ming xing
名义	ming yi
明月	ming yue
命运	ming yun
命中	ming zhong
明珠	ming zhu
名字	ming zi
摩擦	mo ca
魔法	mo fa
模范	mo fan
模仿	mo fang
魔鬼	mo gui
膜蛤	mo ha
膜蛤文化	mo ha wen hua
磨合	mo he
模糊	mo hu
模块	mo kuai
魔力	mo li
莫名其妙	mo ming qi miao
模拟	mo ni
默认	mo ren
陌生	mo sheng
陌生的	mo sheng de
模式	mo shi
没收	mo shou
魔兽	mo shou
磨损	mo sun
模特	mo te
摩托车	mo tuo che
摩托罗拉	mo tuo luo la
墨西哥	mo xi ge
模型	mo xing
末页	mo ye
某个	mou ge
某人	mou ren
谋杀	mou sha
某些	mou xie
某一	mou yi
某种	mou zhong
模板	mu ban
目标	mu biao
目标是	mu biao shi
木材	mu cai
牡丹	mu dan
目的	mu di
目的地	mu di di
目的是	mu di shi
木耳	mu er
母公司	mu gong si
目光	mu guang
模具	mu ju
目录	mu lu
木马	mu ma
目前	mu qian
母亲	mu qin
慕容	mu rong
模样	mu yang
沐浴	mu yu
那边	na bian
拿出	na chu
拿到	na dao
那段	na duan
那儿	na er
哪儿	na er
那份	na fen
那个	na ge
哪个	na ge
那个人	na ge ren
那个时候	na ge shi hou
那就	na jiu
那就是	na jiu shi
拿来	na lai
拿了	na le
那里	na li
哪里	na li
那里的	na li de
那么	na me
那么多	na me duo
纳米	na mi
那你	na ni
那年	na nian
哪怕	na pa
拿起	na qi
那人	na ren
纳入	na ru
那是	na shi
那时	na shi
那时候	na shi hou
纳税	na shui
纳税人	na shui ren
那天	na tian
那位	na wei
那我	na wo
那些	na xie
哪些	na xie
那样	na yang
哪一	na yi
那一刻	na yi ke
那张	na zhang
拿着	na zhe
那只	na zhi
那种	na zhong
哪种	na zhong
奶茶	nai cha
奶酪	nai lao
乃是	nai shi
耐心	nai xin
奶油	nai you
乃至	nai zhi
南北	nan bei
南部	nan bu
南昌	nan chang
难道	nan dao
难得	nan de
男的	nan de
难的	nan de
难得的	nan de de
难点	nan dian
难度	nan du
南方	nan fang
南非	nan fei
难怪	nan guai
难过	nan guo
男孩	nan hai
南海	nan hai
南京市	nan jing shi
南路	nan lu
难免	nan mian
南宁	nan ning
南宁市	nan ning shi
男女	nan nv
男朋友	nan peng you
男人	nan ren
南山	nan shan
男生	nan sheng
男士	nan shi
难受	nan shou
难题	nan ti
南通	nan tong
难忘	nan wang
男性	nan xing
难以	nan yi
男友	nan you
男子	nan zi
脑袋	nao dai
内部	nei bu
内存	nei cun
内地	nei di
内涵	nei han
内核	nei he
内蒙古	nei meng gu
内容	nei rong
内容包括	nei rong bao kuo
内容简介	nei rong jian jie
内容是	nei rong shi
内外	nei wai
内向	nei xiang
内心	nei xin
内心的	nei xin de
内衣	nei yi
内有	nei you
内在	nei zai
内置	nei zhi
能把	neng ba
能不	neng bu
能不能	neng bu neng
能从	neng cong
能对	neng dui
能否	neng fou
能给	neng gei
能够	neng gou
能够在	neng gou zai
能耗	neng hao
能和	neng he
能将	neng jiang
能力	neng li
能力建设	neng li jian she
能力强	neng li qiang
能量	neng liang
能使	neng shi
能说	neng shuo
能为	neng wei
能用	neng yong
能有	neng you
能与	neng yu
能源	neng yuan
能在	neng zai
能做	neng zuo
你啊	ni a
你把	ni ba
你必须	ni bi xu
你不	ni bu
你不是	ni bu shi
昵称	ni cheng
你的	ni de
拟定	ni ding
你都	ni dou
你对	ni dui
你还	ni hai
你好	ni hao
你和	ni he
你会	ni hui
你回	ni hui
你将	ni jiang
你就	ni jiu
你看	ni kan
你可	ni ke
你可以	ni ke yi
你来	ni lai
你们	ni men
匿名	ni ming
你能	ni neng
你去	ni qu
你认为	ni ren wei
你是	ni shi
你是否	ni shi fou
你说	ni shuo
你所	ni suo
你为什么	ni wei shen me
你我	ni wo
你喜欢	ni xi huan
你现在	ni xian zai
你想	ni xiang
你需要	ni xu yao
你要	ni yao
你也	ni ye
你一	ni yi
你一定	ni yi ding
你已经	ni yi jing
你应该	ni ying gai
你有	ni you
你又	ni you
你在	ni zai
你怎么	ni zen me
你这	ni zhe
你这个	ni zhe ge
你真	ni zhen
你只	ni zhi
你知道	ni zhi dao
你自己	ni zi ji
年版	nian ban
年产	nian chan
年初	nian chu
年代	nian dai
年代初	nian dai chu
年底	nian di
年度	nian du
年度报告	nian du bao gao
年份	nian fen
年后	nian hou
年会	nian hui
年级	nian ji
年纪	nian ji
年间	nian jian
年检	nian jian
年来	nian lai
年龄	nian ling
年末	nian mo
年内	nian nei
年前	nian qian
年轻	nian qing
年轻人	nian qing ren
念头	nian tou
年限	nian xian
年月日	nian yue ri
年中	nian zhong
您不	nin bu
您的	nin de
您的位置	nin de wei zhi
您对	nin dui
您还	nin hai
您还没有	nin hai mei you
您好	nin hao
您可以	nin ke yi
您没有	nin mei you
您是	nin shi
您所	nin suo
您现在	nin xian zai
您想	nin xiang
您也	nin ye
您有	nin you
宁波	ning bo
宁波市	ning bo shi
宁静	ning jing
凝聚	ning ju
凝聚力	ning ju li
柠檬	ning meng
宁夏	ning xia
扭矩	niu ju
牛奶	niu nai
牛肉	niu rou
纽约	niu yue
农产品	nong chan pin
农场	nong chang
农村	nong cun
农村经济	nong cun jing ji
弄得	nong de
浓度	nong du
农户	nong hu
农机	nong ji
农历	nong li
农民	nong min
农民房	nong min fang
农民工	nong min gong
浓缩	nong suo
农药	nong yao
农业	nong ye
农业部	nong ye bu
农业科技	nong ye ke ji
农业生产	nong ye sheng chan
农业银行	nong ye yin hang
浓郁	nong yu
农作物	nong zuo wu
努力	nu li
努力提高	nu li ti gao
诺基亚	nuo ji ya
挪用	nuo yong
女的	nv de
女孩	nv hai
女孩子	nv hai zi
女朋友	nv peng you
女人	nv ren
女生	nv sheng
女士	nv shi
女性	nv xing
女友	nv you
女装	nv zhuang
女子	nv zi
殴打	ou da
偶尔	ou er
欧美	ou mei
欧盟	ou meng
偶然	ou ran
呕吐	ou tu
偶像	ou xiang
欧阳	ou yang
欧元	ou yuan
欧洲	ou zhou
排斥	pai chi
排除	pai chu
派出	pai chu
排出	pai chu
派出所	pai chu suo
派的	pai de
拍的	pai de
排队	pai dui
排放	pai fang
拍风景	pai feng jing
排行	pai hang
排行榜	pai hang bang
徘徊	pai huai
排量	pai liang
排列	pai lie
拍卖	pai mai
排名	pai ming
派遣	pai qian
派人	pai ren
拍摄	pai she
排水	pai shui
排序	pai xu
排在	pai zai
拍照	pai zhao
牌照	pai zhao
牌子	pai zi
判定	pan ding
判断	pan duan
判决	pan jue
旁边	pang bian
庞大	pang da
庞大的	pang da de
胖子	pang zi
跑车	pao che
跑到	pao dao
跑了	pao le
泡沫	pao mo
抛弃	pao qi
配备	pei bei
赔偿	pei chang
配方	pei fang
佩服	pei fu
配合	pei he
配件	pei jian
配偶	pei ou
配送	pei song
配送方式	pei song fang shi
配套	pei tao
配套设施	pei tao she shi
陪同	pei tong
培训	pei xun
培训班	pei xun ban
培训机构	pei xun ji gou
培训中心	pei xun zhong xin
培养	pei yang
培养学生	pei yang xue sheng
配有	pei you
培育	pei yu
配置	pei zhi
配制	pei zhi
配置文件	pei zhi wen jian
碰到	peng dao
烹饪	peng ren
朋友	peng you
朋友们	peng you men
膨胀	peng zhang
碰撞	peng zhuang
批次	pi ci
批发	pi fa
批发价	pi fa jia
批发市场	pi fa shi chang
皮肤	pi fu
批复	pi fu
皮革	pi ge
屁股	pi gu
啤酒	pi jiu
疲劳	pi lao
批量	pi liang
披露	pi lu
批判	pi pan
匹配	pi pei
批评	pi ping
脾气	pi qi
譬如	pi ru
批准	pi zhun
批准后	pi zhun hou
偏差	pian cha
片长	pian chang
片段	pian duan
片刻	pian ke
便宜	pian yi
骗子	pian zi
票价	piao jia
票据	piao ju
漂亮	piao liang
品尝	pin chang
频道	pin dao
频繁	pin fan
贫困	pin kun
频率	pin lv
拼命	pin ming
品牌	pin pai
品牌形象	pin pai xing xiang
聘请	pin qing
聘任	pin ren
品味	pin wei
拼音	pin yin
聘用	pin yong
品质	pin zhi
品种	pin zhong
平安	ping an
屏蔽	ping bi
评比	ping bi
评测	ping ce
平常	ping chang
平淡	ping dan
平等	ping deng
评定	ping ding
平凡	ping fan
平方	ping fang
平方公里	ping fang gong li
平方米	ping fang mi
评分	ping fen
评估	ping gu
苹果	ping guo
平和	ping he
平衡	ping heng
评级	ping ji
评价	ping jia
凭借	ping jie
平静	ping jing
瓶颈	ping jing
平均	ping jun
评论	ping lun
平米	ping mi
平面	ping mian
平面设计	ping mian she ji
平民	ping min
屏幕	ping mu
评审	ping shen
平时	ping shi
平台	ping tai
评为	ping wei
评委	ping wei
平稳	ping wen
平行	ping xing
评选	ping xuan
评议	ping yi
平原	ping yuan
凭着	ping zhe
凭证	ping zheng
破案	po an
破产	po chan
破坏	po huai
破解	po jie
破解版	po jie ban
破裂	po lie
迫使	po shi
颇为	po wei
颇有	po you
剖析	pou xi
普遍	pu bian
瀑布	pu bu
普查	pu cha
浦东	pu dong
普洱茶	pu er cha
普及	pu ji
菩萨	pu sa
葡萄	pu tao
葡萄酒	pu tao jiu
普通	pu tong
普通话	pu tong hua
起板	qi ban
起步	qi bu
器材	qi cai
起草	qi cao
汽车	qi che
起床	qi chuang
其次	qi ci
其次是	qi ci shi
期待	qi dai
起到	qi dao
祈祷	qi dao
起到了	qi dao le
气的	qi de
起点	qi dian
启动	qi dong
其二	qi er
启发	qi fa
气氛	qi fen
欺负	qi fu
七个	qi ge
奇怪	qi guai
器官	qi guan
气候	qi hou
其后	qi hou
期货	qi huo
奇迹	qi ji
期间	qi jian
器件	qi jian
其间	qi jian
期间的	qi jian de
器具	qi ju
期刊	qi kan
起来	qi lai
起了	qi le
起码	qi ma
期末	qi mo
期内	qi nei
七年	qi nian
欺骗	qi pian
齐全	qi quan
奇瑞	qi rui
起身	qi shen
其实	qi shi
骑士	qi shi
启示	qi shi
气势	qi shi
岂是	qi shi
歧视	qi shi
其实是	qi shi shi
起诉	qi su
其所	qi suo
其他	qi ta
其他的	qi ta de
其他人	qi ta ren
奇特	qi te
气体	qi ti
企图	qi tu
期望	qi wang
气味	qi wei
气温	qi wen
气息	qi xi
旗下	qi xia
期限	qi xian
期限内	qi xian nei
气象	qi xiang
气象台	qi xiang tai
器械	qi xie
企业	qi ye
企业发展	qi ye fa zhan
企业管理	qi ye guan li
企业家	qi ye jia
企业经营	qi ye jing ying
企业名称	qi ye ming cheng
企业名录	qi ye ming lu
企业内部	qi ye nei bu
企业文化	qi ye wen hua
企业中	qi ye zhong
其一	qi yi
汽油	qi you
其余	qi yu
七月	qi yue
契约	qi yue
欺诈	qi zha
起着	qi zhe
气质	qi zhi
旗帜	qi zhi
其中	qi zhong
其中一个	qi zhong yi ge
其中有	qi zhong you
其主要	qi zhu yao
妻子	qi zi
洽谈	qia tan
前辈	qian bei
签订	qian ding
签订了	qian ding le
前端	qian duan
签发	qian fa
前方	qian fang
前后	qian hou
前进	qian jin
前景	qian jing
千克	qian ke
前款	qian kuan
前来	qian lai
潜力	qian li
千里	qian li
前列	qian lie
前列腺	qian lie xian
乾隆	qian long
前面	qian mian
签名	qian ming
潜能	qian neng
前期	qian qi
嵌入式	qian ru shi
签署	qian shu
潜水	qian shui
前所未有	qian suo wei you
前台	qian tai
前提	qian ti
前提下	qian ti xia
牵头	qian tou
前途	qian tu
千瓦	qian wa
千万	qian wan
千万不要	qian wan bu yao
前往	qian wang
前沿	qian yan
迁移	qian yi
前一	qian yi
牵引	qian yin
千元	qian yuan
签约	qian yue
潜在	qian zai
前者	qian zhe
签证	qian zheng
签字	qian zi
墙壁	qiang bi
强大	qiang da
强的	qiang de
强调	qiang diao
强度	qiang du
强化	qiang hua
强奸	qiang jian
抢劫	qiang jie
强劲	qiang jing
抢救	qiang jiu
强力	qiang li
强烈	qiang lie
墙面	qiang mian
强迫	qiang po
墙上	qiang shang
强势	qiang shi
强行	qiang xing
强有力的	qiang you li de
强制	qiang zhi
强制性	qiang zhi xing
巧克力	qiao ke li
桥梁	qiao liang
切割	qie ge
切换	qie huan
切实	qie shi
切实加强	qie shi jia qiang
亲爱的	qin ai de
侵犯	qin fan
侵犯版权	qin fan ban quan
侵犯了	qin fan le
勤奋	qin fen
侵害	qin hai
禽流感	qin liu gan
亲密	qin mi
亲戚	qin qi
亲切	qin qie
亲情	qin qing
侵权	qin quan
侵权行为	qin quan xing wei
亲人	qin ren
寝室	qin shi
亲属	qin shu
亲自	qin zi
情报	qing bao
请不要	qing bu yao
青菜	qing cai
清朝	qing chao
清澈	qing che
清晨	qing chen
清楚	qing chu
清除	qing chu
清楚地	qing chu de
青春	qing chun
清代	qing dai
清单	qing dan
请到	qing dao
青岛市	qing dao shi
请登录	qing deng lu
请点击	qing dian ji
清风	qing feng
情感	qing gan
青海	qing hai
清华	qing hua
清华大学	qing hua da xue
请及时	qing ji shi
请将	qing jiang
请教	qing jiao
情节	qing jie
清洁	qing jie
请看	qing kan
情况	qing kuang
情况下	qing kuang xia
青睐	qing lai
请来	qing lai
清理	qing li
请联系	qing lian xi
情侣	qing lv
青梅	qing mei
请你	qing ni
青年	qing nian
请您	qing nin
请求	qing qiu
情趣	qing qu
情人	qing ren
情人节	qing ren jie
青山	qing shan
青少年	qing shao nian
清爽	qing shuang
清水	qing shui
轻松	qing song
清算	qing suan
请填写	qing tian xie
倾听	qing ting
请通知	qing tong zhi
青团	qing tuan
轻微	qing wei
请问	qing wen
请勿	qing wu
请勿转载	qing wu zhuan zai
清晰	qing xi
清洗	qing xi
清晰的	qing xi de
请先	qing xian
倾向	qing xiang
倾斜	qing xie
清新	qing xin
情形	qing xing
清醒	qing xing
情绪	qing xu
请选择	qing xuan ze
轻易	qing yi
请用	qing yong
请与	qing yu
请在	qing zai
庆祝	qing zhu
请注明	qing zhu ming
请注意	qing zhu yi
穷人	qiong ren
球场	qiu chang
球队	qiu dui
求购	qiu gou
求购信息	qiu gou xin xi
秋季	qiu ji
球迷	qiu mi
秋天	qiu tian
球员	qiu yuan
求职	qiu zhi
求职者	qiu zhi zhe
求助	qiu zhu
求租	qiu zu
去吧	qu ba
区别	qu bie
取出	qu chu
去除	qu chu
取代	qu dai
渠道	qu dao
取得	qu de
取得了	qu de le
去掉	qu diao
驱动	qu dong
驱动程序	qu dong cheng xu
驱动器	qu dong qi
区分	qu fen
区间	qu jian
取决于	qu jue yu
去看	qu kan
去了	qu le
去买	qu mai
区内	qu nei
去年	qu nian
趋势	qu shi
去世	qu shi
区委	qu wei
趣味	qu wei
曲线	qu xian
区县	qu xian
取消	qu xiao
区域	qu yu
区域内	qu yu nei
去找	qu zhao
区政府	qu zheng fu
去做	qu zuo
全部	quan bu
全场	quan chang
全程	quan cheng
全党	quan dang
全都	quan dou
全额	quan e
全方位	quan fang wei
全国	quan guo
全过程	quan guo cheng
全国各地	quan guo ge di
全集	quan ji
全家	quan jia
全局	quan ju
权利	quan li
权力	quan li
全力	quan li
权利的	quan li de
权利人	quan li ren
全面	quan mian
全面发展	quan mian fa zhan
全面推进	quan mian tui jin
全民	quan min
全年	quan nian
全球	quan qiu
全球化	quan qiu hua
全区	quan qu
全日制	quan ri zhi
全社会	quan she hui
全身	quan shen
全省	quan sheng
全是	quan shi
全世界	quan shi jie
权属	quan shu
全书	quan shu
全套	quan tao
全体	quan ti
全天	quan tian
权威	quan wei
全文	quan wen
权限	quan xian
全县	quan xian
全校	quan xiao
全新	quan xin
全心全意	quan xin quan yi
权益	quan yi
全职	quan zhi
泉州	quan zhou
圈子	quan zi
全自动	quan zi dong
确保	que bao
却被	que bei
却不	que bu
缺点	que dian
确定	que ding
确定了	que ding le
缺乏	que fa
却很	que hen
缺口	que kou
确立	que li
却没有	que mei you
确认	que ren
缺少	que shao
确实	que shi
确实是	que shi shi
缺席	que xi
缺陷	que xian
却也	que ye
却又	que you
却有	que you
确有	que you
却在	que zai
群发	qun fa
群体	qun ti
群众	qun zhong
群众的	qun zhong de
然而	ran er
然后	ran hou
然后再	ran hou zai
燃料	ran liao
燃气	ran qi
燃烧	ran shao
燃油	ran you
让大家	rang da jia
让孩子	rang hai zi
让你	rang ni
让您	rang nin
让人	rang ren
让他	rang ta
让她	rang ta
让它	rang ta
让他们	rang ta men
让我	rang wo
让我们	rang wo men
让学生	rang xue sheng
让自己	rang zi ji
热爱	re ai
热潮	re chao
热点	re dian
热量	re liang
热烈	re lie
热烈的	re lie de
热门	re men
热闹	re nao
热情	re qing
热水	re shui
热水器	re shui qi
热线	re xian
热线电话	re xian dian hua
热心	re xin
人啊	ren a
忍不住	ren bu zhu
人才	ren cai
人才培养	ren cai pei yang
人才市场	ren cai shi chang
人才网	ren cai wang
人次	ren ci
人大	ren da
人大代表	ren da dai biao
认定	ren ding
人多	ren duo
人格	ren ge
人工	ren gong
认购	ren gou
任何	ren he
任何的	ren he de
任何人	ren he ren
任何一个	ren he yi ge
人际关系	ren ji guan xi
人家	ren jia
人间	ren jian
人就	ren jiu
人均	ren jun
认可	ren ke
认可的	ren ke de
人口	ren kou
人类	ren lei
人力	ren li
人力资源	ren li zi yuan
人们	ren men
人民	ren min
人民币	ren min bi
人民法院	ren min fa yuan
人民群众	ren min qun zhong
人民政府	ren min zheng fu
任命	ren ming
人气	ren qi
人去	ren qu
人权	ren quan
人群	ren qun
人身	ren shen
妊娠	ren shen
人参	ren shen
人生	ren sheng
认识	ren shi
人士	ren shi
人是	ren shi
人事	ren shi
人事部	ren shi bu
认识到	ren shi dao
认识的	ren shi de
人事局	ren shi ju
认识了	ren shi le
忍受	ren shou
人数	ren shu
人说	ren shuo
人所	ren suo
人体	ren ti
认同	ren tong
认为	ren wei
人为	ren wei
认为是	ren wei shi
人文	ren wen
任务	ren wu
人物	ren wu
人心	ren xin
人性	ren xing
人性化	ren xing hua
人选	ren xuan
任意	ren yi
人有	ren you
人与	ren yu
人员	ren yuan
人在	ren zai
认真	ren zhen
认真的	ren zhen de
认真贯彻	ren zhen guan che
认真学习	ren zhen xue xi
认证	ren zheng
认知	ren zhi
任职	ren zhi
人之	ren zhi
人中	ren zhong
仍不	reng bu
仍将	reng jiang
仍然	reng ran
仍然是	reng ran shi
仍是	reng shi
仍未	reng wei
仍有	reng you
仍在	reng zai
日报	ri bao
日本人	ri ben ren
日常	ri chang
日常生活	ri chang sheng huo
日出	ri chu
日电	ri dian
日后	ri hou
日记	ri ji
日渐	ri jian
日历	ri li
日内	ri nei
日期	ri qi
日前	ri qian
日趋	ri qu
日益	ri yi
日语	ri yu
日元	ri yuan
日照	ri zhao
日志	ri zhi
日至	ri zhi
日子	ri zi
日子里	ri zi li
融合	rong he
荣获	rong huo
容量	rong liang
容器	rong qi
融入	rong ru
溶液	rong ye
容易	rong yi
荣誉	rong yu
荣誉勋章	rong yu xun zhang
融资	rong zi
柔和	rou he
柔软	rou ruan
肉体	rou ti
肉眼	rou yan
如不	ru bu
如此	ru ci
乳房	ru fang
如果	ru guo
如果不	ru guo bu
如果不是	ru guo bu shi
如果没有	ru guo mei you
如果说	ru guo shuo
如果要	ru guo yao
如果有	ru guo you
如果在	ru guo zai
如何	ru he
如今	ru jin
入境	ru jing
入口	ru kou
入库	ru ku
如来	ru lai
入门	ru men
入侵	ru qin
如是	ru shi
如实	ru shi
入手	ru shou
如同	ru tong
如图	ru tu
如下	ru xia
如需	ru xu
入选	ru xuan
入学	ru xue
如意	ru yi
如有	ru you
如在	ru zai
入住	ru zhu
软件	ruan jian
软件大小	ruan jian da xiao
软件简介	ruan jian jian jie
软件开发	ruan jian kai fa
软件类别	ruan jian lei bie
软件名称	ruan jian ming cheng
软件下载	ruan jian xia zai
软件语言	ruan jian yu yan
瑞典	rui dian
瑞士	rui shi
润滑油	run hua you
若不	ruo bu
弱点	ruo dian
若干	ruo gan
若是	ruo shi
若有	ruo you
萨达姆	sa da mu
赛车	sai che
赛季	sai ji
赛事	sai shi
散步	san bu
三层	san ceng
三次	san ci
三大	san da
三等奖	san deng jiang
散发	san fa
三分	san fen
三分之一	san fen zhi yi
三个	san ge
三个代表	san ge dai biao
三个月	san ge yue
三国	san guo
三级	san ji
三角	san jiao
三类	san lei
三菱	san ling
三楼	san lou
三年	san nian
三农	san nong
三七	san qi
散热	san re
三人	san ren
三是	san shi
三十	san shi
三天	san tian
三维	san wei
散文	san wen
三峡	san xia
三项	san xiang
三星	san xing
三亚	san ya
三月	san yue
三者	san zhe
三种	san zhong
丧失	sang shi
扫描	sao miao
骚扰	sao rao
色彩	se cai
色调	se diao
色情	se qing
色泽	se ze
森林	sen lin
刹车	sha che
杀毒	sha du
杀毒软件	sha du ruan jian
沙发	sha fa
沙拉	sha la
杀了	sha le
沙龙	sha long
沙漠	sha mo
杀人	sha ren
杀手	sha shou
杀死	sha si
沙滩	sha tan
筛选	shai xuan
擅长	shan chang
删除	shan chu
山的	shan de
闪电	shan dian
山顶	shan ding
山东	shan dong
煽动	shan dong
山东省	shan dong sheng
闪光	shan guang
善良	shan liang
山路	shan lu
山区	shan qu
山上	shan shang
山水	shan shui
闪烁	shan shuo
汕头	shan tou
山西	shan xi
陕西	shan xi
山西省	shan xi sheng
陕西省	shan xi sheng
善于	shan yu
山庄	shan zhuang
擅自	shan zi
上班	shang ban
上半年	shang ban nian
上报	shang bao
商标	shang biao
商场	shang chang
商城	shang cheng
上传	shang chuan
上传时间	shang chuan shi jian
上次	shang ci
上的	shang de
上帝	shang di
商店	shang dian
上方	shang fang
上岗	shang gang
上海	shang hai
伤害	shang hai
上海的	shang hai de
上海市	shang hai shi
商户	shang hu
上级	shang ji
商机	shang ji
商家	shang jia
上架	shang jia
上看	shang kan
上课	shang ke
伤口	shang kou
上来	shang lai
上了	shang le
商量	shang liang
商贸	shang mao
上门	shang men
上面	shang mian
商品	shang pin
商品房	shang pin fang
商品价格	shang pin jia ge
商品名称	shang pin ming cheng
商品型号	shang pin xing hao
商铺	shang pu
上前	shang qian
上去	shang qu
商人	shang ren
上升	shang sheng
上市	shang shi
上市公司	shang shi gong si
上世纪	shang shi ji
上述	shang shu
上司	shang si
上网	shang wang
尚未	shang wei
上午	shang wu
商务	shang wu
商务部	shang wu bu
上下	shang xia
上线	shang xian
伤心	shang xin
上学	shang xue
商学院	shang xue yuan
上演	shang yan
商业	shang ye
商业贿赂	shang ye hui lu
商业银行	shang ye yin hang
上一页	shang yi ye
上一主题	shang yi zhu ti
商用	shang yong
上有	shang you
上游	shang you
尚有	shang you
上涨	shang zhang
上周	shang zhou
少的	shao de
烧烤	shao kao
少了	shao le
少量	shao liang
少年	shao nian
少女	shao nv
少数	shao shu
少数民族	shao shu min zu
稍微	shao wei
绍兴	shao xing
少许	shao xu
少于	shao yu
少做	shao zuo
少做一些	shao zuo yi xie
涉案	she an
设备	she bei
设定	she ding
社会保险	she hui bao xian
社会保障	she hui bao zhang
社会发展	she hui fa zhan
社会各界	she hui ge jie
社会化	she hui hua
社会经济	she hui jing ji
社会科学	she hui ke xue
社会上	she hui shang
社会团体	she hui tuan ti
社会效益	she hui xiao yi
社会治安	she hui zhi an
社会主义	she hui zhu yi
设计	she ji
涉及	she ji
射击	she ji
涉及到	she ji dao
设计的	she ji de
设计得	she ji de
涉及的	she ji de
设计师	she ji shi
设立	she li
设立了	she li le
社区	she qu
摄入	she ru
设施	she shi
舌头	she tou
社团	she tuan
涉外	she wai
设为	she wei
设为首页	she wei shou ye
涉嫌	she xian
设想	she xiang
摄像	she xiang
摄像机	she xiang ji
摄像头	she xiang tou
摄影	she ying
设有	she you
设在	she zai
设置	she zhi
设置为	she zhi wei
谁的	shei de
谁都	shei dou
谁能	shei neng
谁是	shei shi
谁也	shei ye
谁知	shei zhi
申办	shen ban
申报	shen bao
身边	shen bian
身材	shen cai
深层	shen ceng
审查	shen cha
深处	shen chu
伸出	shen chu
神的	shen de
审定	shen ding
深度	shen du
身份	shen fen
身份证	shen fen zheng
身高	shen gao
审核	shen he
身后	shen hou
审计	shen ji
神经	shen jing
深刻	shen ke
深刻的	shen ke de
审理	shen li
什么	shen me
什么东西	shen me dong xi
什么呢	shen me ne
什么人	shen me ren
什么是	shen me shi
什么事	shen me shi
什么时候	shen me shi hou
什么样的	shen me yang de
什么也	shen me ye
审美	shen mei
神秘	shen mi
申明	shen ming
审判	shen pan
身旁	shen pang
审批	shen pi
神奇	shen qi
申请	shen qing
神情	shen qing
深情	shen qing
申请表	shen qing biao
申请材料	shen qing cai liao
申请人	shen qing ren
申请书	shen qing shu
深入	shen ru
深入的	shen ru de
深入开展	shen ru kai zhan
神色	shen se
身上	shen shang
深受	shen shou
伸手	shen shou
申诉	shen su
身体	shen ti
身体健康	shen ti jian kang
渗透	shen tou
身为	shen wei
神仙	shen xian
身心	shen xin
沈阳	shen yang
沈阳市	shen yang shi
深夜	shen ye
审议	shen yi
身影	shen ying
深远	shen yuan
深圳	shen zhen
深圳市	shen zhen shi
甚至	shen zhi
慎重	shen zhong
身子	shen zi
生病	sheng bing
生产	sheng chan
生产厂家	sheng chan chang jia
生产工艺	sheng chan gong yi
生产基地	sheng chan ji di
生产技术	sheng chan ji shu
生产经营	sheng chan jing ying
生产力	sheng chan li
生产能力	sheng chan neng li
生产企业	sheng chan qi ye
生产商	sheng chan shang
生产设备	sheng chan she bei
生产线	sheng chan xian
生产者	sheng chan zhe
生成	sheng cheng
声称	sheng cheng
生存	sheng cun
盛大	sheng da
圣诞	sheng dan
圣诞节	sheng dan jie
声道	sheng dao
生的	sheng de
省的	sheng de
生动	sheng dong
省份	sheng fen
升高	sheng gao
生化	sheng hua
升华	sheng hua
盛会	sheng hui
生活	sheng huo
生活方式	sheng huo fang shi
生活中	sheng huo zhong
生活中的	sheng huo zhong de
升级	sheng ji
省级	sheng ji
升级到	sheng ji dao
生姜	sheng jiang
声卡	sheng ka
生了	sheng le
胜利	sheng li
生理	sheng li
生命	sheng ming
声明	sheng ming
生命力	sheng ming li
省内	sheng nei
生气	sheng qi
圣人	sheng ren
生日	sheng ri
省市	sheng shi
生死	sheng si
生态	sheng tai
生态环境	sheng tai huan jing
声望	sheng wang
省委	sheng wei
生物	sheng wu
剩下的	sheng xia de
生效	sheng xiao
生涯	sheng ya
生意	sheng yi
升一下级	sheng yi xia ji
声音	sheng yin
剩余	sheng yu
生育	sheng yu
生于	sheng yu
声誉	sheng yu
生在	sheng zai
生长	sheng zhang
省政府	sheng zheng fu
升值	sheng zhi
是啊	shi a
是按	shi an
失败	shi bai
失败的	shi bai de
时报	shi bao
是被	shi bei
势必	shi bi
识别	shi bie
士兵	shi bing
是不是	shi bu shi
食材	shi cai
石材	shi cai
视察	shi cha
市场	shi chang
时常	shi chang
市场份额	shi chang fen e
市场化	shi chang hua
市场价	shi chang jia
市场价格	shi chang jia ge
市场经济	shi chang jing ji
市场竞争	shi chang jing zheng
市场上	shi chang shang
市场需求	shi chang xu qiu
市场营销	shi chang ying xiao
是从	shi cong
十大	shi da
时代	shi dai
适当	shi dang
适当的	shi dang de
是的	shi de
似的	shi de
使得	shi de
实地	shi di
湿地	shi di
试点	shi dian
试点工作	shi dian gong zuo
适度	shi du
湿度	shi du
时段	shi duan
是对	shi dui
是多么	shi duo me
是多少	shi duo shao
十二月	shi er yue
始发站	shi fa zhan
示范	shi fan
释放	shi fang
是非	shi fei
是非常	shi fei chang
十分	shi fen
是否	shi fou
是该	shi gai
石膏	shi gao
是个	shi ge
诗歌	shi ge
十个	shi ge
是给	shi gei
施工	shi gong
施工单位	shi gong dan wei
事故	shi gu
时光	shi guang
是国内	shi guo nei
是好	shi hao
适合	shi he
是和	shi he
适合于	shi he yu
是很	shi hen
时候	shi hou
事后	shi hou
实惠	shi hui
实际	shi ji
世纪	shi ji
市级	shi ji
时机	shi ji
十几	shi ji
事迹	shi ji
实际情况	shi ji qing kuang
实际上	shi ji shang
石家庄	shi jia zhuang
时间	shi jian
事件	shi jian
实践	shi jian
世间	shi jian
是件	shi jian
时间的	shi jian de
实践的	shi jian de
实践活动	shi jian huo dong
时间里	shi jian li
时间内	shi jian nei
时间为	shi jian wei
实践中	shi jian zhong
是将	shi jiang
视角	shi jiao
世界	shi jie
世界杯	shi jie bei
世界各地	shi jie ge di
世界各国	shi jie ge guo
世界观	shi jie guan
世界里	shi jie li
世界上	shi jie shang
试卷	shi juan
视觉	shi jue
是靠	shi kao
时刻	shi ke
是可以	shi ke yi
时空	shi kong
实力	shi li
实例	shi li
势力	shi li
示例	shi li
视力	shi li
室里	shi li
适量	shi liang
十六	shi liu
石榴	shi liu
十六届	shi liu jie
失落	shi luo
是吗	shi ma
是没	shi mei
失眠	shi mian
市民	shi min
使命	shi ming
是目前	shi mu qian
室内	shi nei
市内	shi nei
是你	shi ni
使你	shi ni
十年	shi nian
是您	shi nin
使您	shi nin
视频	shi pin
食品	shi pin
饰品	shi pin
食品安全	shi pin an quan
时期	shi qi
使其	shi qi
十七	shi qi
事情	shi qing
失去	shi qu
是去	shi qu
市区	shi qu
拾取	shi qu
时区	shi qu
失去了	shi qu le
是让	shi rang
使人	shi ren
诗人	shi ren
是人	shi ren
世人	shi ren
是人类	shi ren lei
十三	shi san
时尚	shi shang
史上	shi shang
世上	shi shang
是谁	shi shei
师生	shi sheng
事实	shi shi
实施	shi shi
实时	shi shi
适时	shi shi
实施办法	shi shi ban fa
实施的	shi shi de
实施方案	shi shi fang an
是世界上	shi shi jie shang
实事求是	shi shi qiu shi
事实上	shi shi shang
实施细则	shi shi xi ze
是谁	shi shui
是说	shi shuo
是他	shi ta
是她	shi ta
使他	shi ta
是它	shi ta
使它	shi ta
是他们	shi ta men
是她们	shi ta men
使他们	shi ta men
是它们	shi ta men
食堂	shi tang
试题	shi ti
实体	shi ti
尸体	shi ti
试听	shi ting
视听	shi ting
石头	shi tou
势头	shi tou
试图	shi tu
视图	shi tu
室外	shi wai
失望	shi wang
视为	shi wei
是位	shi wei
是我	shi wo
使我	shi wo
是我国	shi wo guo
使我们	shi wo men
食物	shi wu
失误	shi wu
事物	shi wu
事务	shi wu
十五	shi wu
实物	shi wu
实务	shi wu
事物的	shi wu de
事务所	shi wu suo
实习	shi xi
实现	shi xian
事先	shi xian
视线	shi xian
时限	shi xian
实现了	shi xian le
事项	shi xiang
是想	shi xiang
失效	shi xiao
是小	shi xiao
实效	shi xiao
实行	shi xing
施行	shi xing
试行	shi xing
师兄	shi xiong
使学生	shi xue sheng
实验	shi yan
试验	shi yan
饰演	shi yan
实验室	shi yan shi
是要	shi yao
事业	shi ye
视野	shi ye
失业	shi ye
事业单位	shi ye dan wei
事业发展	shi ye fa zhan
是以	shi yi
十一	shi yi
是一	shi yi
事宜	shi yi
适宜	shi yi
是一个	shi yi ge
是一家	shi yi jia
是一款	shi yi kuan
是一位	shi yi wei
十一五	shi yi wu
是一项	shi yi xiang
是一样的	shi yi yang de
十一月	shi yi yue
是一种	shi yi zhong
是因为	shi yin wei
适应	shi ying
市盈率	shi ying lv
使用	shi yong
使用的	shi yong de
实用的	shi yong de
适用的	shi yong de
适用范围	shi yong fan wei
使用方法	shi yong fang fa
使用了	shi yong le
使用权	shi yong quan
使用时	shi yong shi
实用性	shi yong xing
适用于	shi yong yu
使用者	shi yong zhe
使用着	shi yong zhe
是由	shi you
石油	shi you
时有	shi you
是由于	shi you yu
是与	shi yu
十月	shi yue
实在	shi zai
是在	shi zai
实在是	shi zai shi
实战	shi zhan
市长	shi zhang
使者	shi zhe
试着	shi zhe
是这样的	shi zhe yang de
是真	shi zhen
市政	shi zheng
市政府	shi zheng fu
是指	shi zhi
使之	shi zhi
实质	shi zhi
始终	shi zhong
时钟	shi zhong
是中国	shi zhong guo
时装	shi zhuang
狮子	shi zi
师资	shi zi
使自己	shi zi ji
失踪	shi zong
十足	shi zu
是最好的	shi zui hao de
手按	shou an
手臂	shou bi
手表	shou biao
收藏	shou cang
收藏本页	shou cang ben ye
收藏夹	shou cang jia
手册	shou ce
手持	shou chi
首次	shou ci
受到	shou dao
收到	shou dao
收到后	shou dao hou
受到了	shou dao le
收到了	shou dao le
手的	shou de
手动	shou dong
首都	shou du
手段	shou duan
守法	shou fa
手法	shou fa
首发	shou fa
收费	shou fei
收费标准	shou fei biao zhun
手感	shou gan
手工	shou gong
收购	shou gou
售后	shou hou
售后服务	shou hou fu wu
收回	shou hui
收获	shou huo
收货人	shou huo ren
手机	shou ji
收集	shou ji
手机短信	shou ji duan xin
手机号码	shou ji hao ma
售价	shou jia
首家	shou jia
首届	shou jie
授课	shou ke
受了	shou le
受理	shou li
手里	shou li
收录	shou lu
寿命	shou ming
首批	shou pi
收取	shou qu
授权	shou quan
授权方式	shou quan fang shi
收入	shou ru
受伤	shou shang
手上	shou shang
收拾	shou shi
首饰	shou shi
手术	shou shu
受损	shou sun
收缩	shou suo
手套	shou tao
熟悉	shou xi
首席	shou xi
手下	shou xia
首先	shou xian
首先要	shou xian yao
手续	shou xu
手续费	shou xu fei
首选	shou xuan
首页	shou ye
收益	shou yi
受益	shou yi
授予	shou yu
手指	shou zhi
收支	shou zhi
手中	shou zhong
数百	shu bai
鼠标	shu biao
蔬菜	shu cai
输出	shu chu
书的	shu de
数的	shu de
书店	shu dian
数额	shu e
书法	shu fa
舒服	shu fu
束缚	shu fu
术后	shu hou
书画	shu hua
书籍	shu ji
暑假	shu jia
数据	shu ju
数据包	shu ju bao
数据查询	shu ju cha xun
数据结构	shu ju jie gou
数据库	shu ju ku
数据库的	shu ju ku de
数据类型	shu ju lei xing
数据线	shu ju xian
数控	shu kong
树立	shu li
熟练	shu lian
数量	shu liang
数码	shu ma
数码相机	shu ma xiang ji
书面	shu mian
书名	shu ming
数目	shu mu
树木	shu mu
输入	shu ru
输入法	shu ru fa
书生	shu sheng
舒适	shu shi
舒适的	shu shi de
输送	shu song
熟悉	shu xi
书写	shu xie
属性	shu xing
数学	shu xue
属于	shu yu
术语	shu yu
属于自己	shu yu zi ji
数值	shu zhi
树脂	shu zhi
书中	shu zhong
数字	shu zi
数字电视	shu zi dian shi
数字化	shu zi hua
数组	shu zu
刷新	shua xin
帅哥	shuai ge
率领	shuai ling
率先	shuai xian
双重	shuang chong
双方	shuang fang
双击	shuang ji
双手	shuang shou
双向	shuang xiang
双眼	shuang yan
双赢	shuang ying
水产	shui chan
水产品	shui chan pin
水稻	shui dao
水的	shui de
谁的	shui de
水电	shui dian
谁都	shui dou
税法	shui fa
税费	shui fei
水分	shui fen
水果	shui guo
睡觉	shui jiao
水晶	shui jing
水库	shui ku
税款	shui kuan
水利	shui li
税率	shui lv
睡眠	shui mian
谁能	shui neng
水泥	shui ni
水平	shui ping
水上	shui shang
谁是	shui shi
税收	shui shou
税务	shui wu
税务机关	shui wu ji guan
谁也	shui ye
水域	shui yu
水源	shui yuan
水质	shui zhi
谁知	shui zhi
水中	shui zhong
水准	shui zhun
水资源	shui zi yuan
顺便	shun bian
顺德	shun de
瞬间	shun jian
顺利	shun li
顺序	shun xu
顺着	shun zhe
说不	shuo bu
说不定	shuo bu ding
说出	shuo chu
说到	shuo dao
说的	shuo de
说得	shuo de
说法	shuo fa
说服	shuo fu
说过	shuo guo
说话	shuo hua
说了	shuo le
说明	shuo ming
说明书	shuo ming shu
说你	shuo ni
说起	shuo qi
说什么	shuo shen me
说是	shuo shi
硕士	shuo shi
说实话	shuo shi hua
硕士学位	shuo shi xue wei
说他	shuo ta
说她	shuo ta
说完	shuo wan
说我	shuo wo
说着	shuo zhe
四处	si chu
四川	si chuan
四川省	si chuan sheng
四大	si da
死的	si de
司法	si fa
四方	si fang
私服	si fu
四个	si ge
丝毫	si hao
死后	si hou
似乎	si hu
司机	si ji
四级	si ji
四季	si ji
思考	si kao
死了	si le
饲料	si liao
思路	si lu
司马	si ma
思念	si nian
私人	si ren
四人	si ren
四是	si shi
四十	si shi
斯特	si te
死亡	si wang
思维	si wei
思想	si xiang
思想道德	si xiang dao de
思想政治	si xiang zheng zhi
饲养	si yang
私营企业	si ying qi ye
私语	si yu
四月	si yue
死者	si zhe
四种	si zhong
四周	si zhou
送达	song da
送到	song dao
送给	song gei
送货	song huo
送货上门	song huo shang men
送上	song shang
宋体	song ti
松下	song xia
搜狐	sou hu
搜集	sou ji
搜索	sou suo
搜索结果	sou suo jie guo
搜索引擎	sou suo yin qing
素材	su cai
俗称	su cheng
素的	su de
速度	su du
速度快	su du kuai
塑胶	su jiao
苏联	su lian
塑料	su liao
速率	su lv
宿舍	su she
诉讼	su song
素养	su yang
塑造	su zao
素质	su zhi
素质教育	su zhi jiao yu
苏州	su zhou
苏州市	su zhou shi
算法	suan fa
算了	suan le
酸奶	suan nai
算是	suan shi
随便	sui bian
隧道	sui dao
随后	sui hou
随机	sui ji
随即	sui ji
虽然	sui ran
虽然是	sui ran shi
虽然在	sui ran zai
随时	sui shi
岁时	sui shi
随时随地	sui shi sui di
虽说	sui shuo
随意	sui yi
岁月	sui yue
随着	sui zhe
随之	sui zhi
损害	sun hai
损坏	sun huai
损伤	sun shang
损失	sun shi
所产	suo chan
所称	suo cheng
所持	suo chi
所处	suo chu
所带	suo dai
所得	suo de
所得税	suo de shui
锁定	suo ding
锁定的	suo ding de
缩短	suo duan
所发	suo fa
所列	suo lie
所能	suo neng
索尼	suo ni
索赔	suo pei
索取	suo qu
所示	suo shi
所使用	suo shi yong
所属	suo shu
所属行业	suo shu hang ye
所说	suo shuo
所提供	suo ti gong
所谓	suo wei
缩小	suo xiao
所需	suo xu
所需要的	suo xu yao de
所学	suo xue
所要	suo yao
所以	suo yi
所以说	suo yi shuo
所以我	suo yi wo
所以在	suo yi zai
索引	suo yin
所引起	suo yin qi
所用	suo yong
所有	suo you
所有权	suo you quan
所有人	suo you ren
所有信息	suo you xin xi
所在	suo zai
所在单位	suo zai dan wei
所在地	suo zai di
所在地区	suo zai di qu
所造成	suo zao cheng
所占	suo zhan
所长	suo zhang
所致	suo zhi
所做	suo zuo
他把	ta ba
他不	ta bu
她不	ta bu
它不	ta bu
他才	ta cai
他从	ta cong
他的	ta de
她的	ta de
它的	ta de
他都	ta dou
他对	ta dui
她对	ta dui
他还	ta hai
她还	ta hai
它还	ta hai
他和	ta he
她和	ta he
他很	ta hen
他会	ta hui
她会	ta hui
它会	ta hui
他将	ta jiang
它将	ta jiang
他就	ta jiu
她就	ta jiu
它就	ta jiu
他看	ta kan
他可	ta ke
他没	ta mei
他们	ta men
他们的	ta men de
他们都	ta men dou
他们是	ta men shi
他那	ta na
她那	ta na
它能	ta neng
他却	ta que
他人	ta ren
他认为	ta ren wei
他是	ta shi
她是	ta shi
它是	ta shi
他说	ta shuo
她说	ta shuo
他所	ta suo
他为	ta wei
他想	ta xiang
他要	ta yao
他也	ta ye
她也	ta ye
它也	ta ye
他一	ta yi
他已经	ta yi jing
他用	ta yong
他又	ta you
他有	ta you
她又	ta you
它有	ta you
她有	ta you
他在	ta zai
她在	ta zai
它在	ta zai
他只	ta zhi
他自己	ta zi ji
台北	tai bei
太大	tai da
态度	tai du
太多	tai duo
太多了	tai duo le
太多了吧	tai duo le ba
胎儿	tai er
太高	tai gao
太过	tai guo
太极	tai ji
台阶	tai jie
太空	tai kong
太平	tai ping
太平洋	tai ping yang
泰山	tai shan
台上	tai shang
态势	tai shi
抬头	tai tou
台湾	tai wan
太阳	tai yang
太阳能	tai yang neng
台州	tai zhou
太子	tai zi
探测	tan ce
弹出	tan chu
谈到	tan dao
谈话	tan hua
谈家渡桥	tan jia du qiao
探究	tan jiu
坦克	tan ke
叹了	tan le
谈论	tan lun
谈判	tan pan
探索	tan suo
探讨	tan tao
叹息	tan xi
探险	tan xian
弹性	tan xing
唐代	tang dai
糖尿病	tang niao bing
倘若	tang ruo
唐山	tang shan
躺在	tang zai
淘宝	tao bao
逃避	tao bi
套餐	tao can
掏出	tao chu
陶瓷	tao ci
套房	tao fang
桃花	tao hua
讨论	tao lun
讨论区	tao lun qu
淘汰	tao tai
讨厌	tao yan
套装	tao zhuang
特别	te bie
特别是	te bie shi
特别是在	te bie shi zai
特产	te chan
特长	te chang
特点	te dian
特点是	te dian shi
特定	te ding
特价	te jia
特价机票	te jia ji piao
特权	te quan
特色	te se
特殊	te shu
特殊情况	te shu qing kuang
特效	te xiao
特性	te xing
特意	te yi
特有	te you
特约	te yue
特征	te zheng
特制	te zhi
特质	te zhi
特种	te zhong
疼痛	teng tong
腾讯	teng xun
提案	ti an
题材	ti cai
提倡	ti chang
提成	ti cheng
提出	ti chu
提出了	ti chu le
提出申请	ti chu shen qing
替代	ti dai
提到	ti dao
提高	ti gao
提高到	ti gao dao
提高了	ti gao le
提供	ti gong
提供服务	ti gong fu wu
提供给	ti gong gei
提供了	ti gong le
提供商	ti gong shang
提供一个	ti gong yi ge
提供者	ti gong zhe
替换	ti huan
体会	ti hui
体会到	ti hui dao
体积	ti ji
提及	ti ji
体检	ti jian
提交	ti jiao
体力	ti li
提名	ti ming
题目	ti mu
体内	ti nei
提起	ti qi
提起诉讼	ti qi su song
提前	ti qian
提取	ti qu
提升	ti sheng
提示信息	ti shi xin xi
提问	ti wen
体系	ti xi
体系建设	ti xi jian she
体现	ti xian
体现出	ti xian chu
体现了	ti xian le
体现在	ti xian zai
提醒	ti xing
题型	ti xing
体验	ti yan
提议	ti yi
体育	ti yu
体制	ti zhi
体质	ti zhi
体制改革	ti zhi gai ge
体重	ti zhong
填报	tian bao
天才	tian cai
填充	tian chong
天地	tian di
天赋	tian fu
天后	tian hou
添加	tian jia
添加剂	tian jia ji
天津	tian jin
天津市	tian jin shi
天空	tian kong
甜蜜	tian mi
天内	tian nei
天气	tian qi
天然	tian ran
天然气	tian ran qi
天上	tian shang
天生	tian sheng
天使	tian shi
天数	tian shu
天堂	tian tang
天下	tian xia
甜咸	tian xian
天线	tian xian
填写	tian xie
天涯	tian ya
天真	tian zhen
跳槽	tiao cao
条规	tiao gui
条件	tiao jian
条件下	tiao jian xia
调节	tiao jie
调解	tiao jie
调控	tiao kong
条款	tiao kuan
条例	tiao li
条码	tiao ma
调试	tiao shi
跳舞	tiao wu
挑选	tiao xuan
跳跃	tiao yue
挑战	tiao zhan
调整	tiao zheng
铁板	tie ban
贴的	tie de
贴近	tie jin
铁路	tie lu
铁树	tie shu
贴图	tie tu
帖子	tie zi
停车	ting che
停车场	ting che chang
听到	ting dao
听得	ting de
听见	ting jian
听课	ting ke
听了	ting le
停了	ting le
听力	ting li
停留	ting liu
听取	ting qu
听说	ting shuo
停下	ting xia
听着	ting zhe
听证	ting zheng
停止	ting zhi
听众	ting zhong
同伴	tong ban
通报	tong bao
同比	tong bi
同比增长	tong bi zeng zhang
同步	tong bu
通常	tong chang
通常是	tong chang shi
统筹	tong chou
通道	tong dao
同等	tong deng
通风	tong feng
通告	tong gao
通过	tong guo
通过了	tong guo le
通过网络	tong guo wang luo
同行	tong hang
通话	tong hua
童话	tong hua
统计	tong ji
同级	tong ji
统计数据	tong ji shu ju
痛苦	tong ku
痛苦的	tong ku de
同类	tong lei
童年	tong nian
同期	tong qi
同情	tong qing
同上	tong shang
同时	tong shi
同事	tong shi
同时也	tong shi ye
通往	tong wang
通信	tong xin
同行	tong xing
通行	tong xing
同学	tong xue
同学们	tong xue men
通讯	tong xun
通讯地址	tong xun di zhi
同样	tong yang
同样是	tong yang shi
同意	tong yi
统一的	tong yi de
同一个	tong yi ge
通用	tong yong
通知	tong zhi
同志们	tong zhi men
通知书	tong zhi shu
投保	tou bao
投标	tou biao
投标人	tou biao ren
头部	tou bu
投产	tou chan
头的	tou de
头顶	tou ding
头发	tou fa
投放	tou fang
投稿	tou gao
透过	tou guo
投机	tou ji
透露	tou lu
透明	tou ming
透明的	tou ming de
透明度	tou ming du
头脑	tou nao
投票	tou piao
投入	tou ru
头上	tou shang
投诉	tou su
头痛	tou tong
头衔	tou xian
头像	tou xiang
投影	tou ying
投影机	tou ying ji
投注	tou zhu
投资	tou zi
投资项目	tou zi xiang mu
投资者	tou zi zhe
图案	tu an
图标	tu biao
徒步	tu bu
图层	tu ceng
突出	tu chu
突出的	tu chu de
突出问题	tu chu wen ti
土地	tu di
土豆	tu dou
突发	tu fa
突发事件	tu fa shi jian
途径	tu jing
图库	tu ku
图例	tu li
涂料	tu liao
涂抹	tu mo
图片	tu pian
突破	tu po
突然	tu ran
土壤	tu rang
图书	tu shu
图书馆	tu shu guan
图文	tu wen
图像	tu xiang
图形	tu xing
图纸	tu zhi
途中	tu zhong
兔子	tu zi
团队	tuan dui
团购	tuan gou
团结	tuan jie
团体	tuan ti
团委	tuan wei
团员	tuan yuan
团长	tuan zhang
团组织	tuan zu zhi
推迟	tui chi
推出	tui chu
退出	tui chu
退出后	tui chu hou
推出后	tui chu hou
推出了	tui chu le
推动	tui dong
推动了	tui dong le
推翻	tui fan
推广	tui guang
退还	tui huan
退回	tui hui
退货	tui huo
推荐	tui jian
推荐的	tui jian de
推荐给	tui jian gei
推荐使用	tui jian shi yong
推介	tui jie
推进	tui jin
推开	tui kai
推理	tui li
推向	tui xiang
推销	tui xiao
推行	tui xing
退休	tui xiu
臀部	tun bu
托管	tuo guan
拓宽	tuo kuan
脱离	tuo li
脱落	tuo luo
托盘	tuo pan
拖欠	tuo qian
脱颖而出	tuo ying er chu
拓展	tuo zhan
挖掘	wa jue
外包	wai bao
外表	wai biao
外部	wai bu
外出	wai chu
外地	wai di
外挂	wai gua
外观	wai guan
外国	wai guo
外国人	wai guo ren
外汇	wai hui
外交	wai jiao
外界	wai jie
外壳	wai ke
外科	wai ke
外来	wai lai
外贸	wai mao
外面	wai mian
外商	wai shang
外商投资	wai shang tou zi
外套	wai tao
外形	wai xing
外型	wai xing
外语	wai yu
外在	wai zai
外资	wai zi
外资企业	wai zi qi ye
完毕	wan bi
晚餐	wan can
完成	wan cheng
完成后	wan cheng hou
完成了	wan cheng le
玩的	wan de
万吨	wan dun
万多	wan duo
万股	wan gu
晚会	wan hui
玩家	wan jia
玩具	wan ju
完了	wan le
万里	wan li
万辆	wan liang
完美	wan mei
完美的	wan mei de
万美元	wan mei yuan
万亩	wan mu
弯曲	wan qu
完全	wan quan
完全不	wan quan bu
完全可以	wan quan ke yi
完全是	wan quan shi
万人	wan ren
完善	wan shan
晚上	wan shang
万台	wan tai
万物	wan wu
玩笑	wan xiao
万一	wan yi
万余	wan yu
万元	wan yuan
万元以上	wan yuan yi shang
万元以下	wan yuan yi xia
完整	wan zheng
完整性	wan zheng xing
网吧	wang ba
王朝	wang chao
网点	wang dian
网店	wang dian
往返	wang fan
网管	wang guan
网关	wang guan
王国	wang guo
忘记	wang ji
忘记了	wang ji le
忘记密码	wang ji mi ma
网卡	wang ka
往来	wang lai
忘了	wang le
网络	wang luo
网络安全	wang luo an quan
网络服务	wang luo fu wu
网络广告	wang luo guang gao
网络技术	wang luo ji shu
网络实名	wang luo shi ming
网络营销	wang luo ying xiao
网络游戏	wang luo you xi
网民	wang min
网名	wang ming
网上	wang shang
往事	wang shi
网通	wang tong
王先生	wang xian sheng
网页	wang ye
网易	wang yi
网友	wang you
网游	wang you
网友观点	wang you guan dian
网友评论	wang you ping lun
网站	wang zhan
网站建设	wang zhan jian she
望着	wang zhe
网址	wang zhi
王子	wang zi
为保证	wei bao zheng
违背	wei bei
为本	wei ben
未必	wei bi
未成年	wei cheng nian
未成年人	wei cheng nian ren
维持	wei chi
为此	wei ci
伟大	wei da
伟大的	wei da de
为大家	wei da jia
为代表	wei dai biao
味道	wei dao
违法	wei fa
违法所得	wei fa suo de
违法行为	wei fa xing wei
违反	wei fan
为该	wei gai
为广大	wei guang da
违规	wei gui
为国家	wei guo jia
危害	wei hai
威海	wei hai
为何	wei he
为核心	wei he xin
维护	wei hu
未婚	wei hun
危机	wei ji
为基础	wei ji chu
为基础的	wei ji chu de
为进一步	wei jin yi bu
未经	wei jing
未经同意	wei jing tong yi
未经许可	wei jing xu ke
为客户	wei ke hu
未来	wei lai
未来的	wei lai de
为了	wei le
为了保证	wei le bao zheng
为了达到	wei le da dao
为了让	wei le rang
威力	wei li
为民	wei min
为目标	wei mu biao
未能	wei neng
为你	wei ni
为您	wei nin
为您提供	wei nin ti gong
为其	wei qi
为期	wei qi
为企业	wei qi ye
委屈	wei qu
维权	wei quan
为确保	wei que bao
围绕	wei rao
为人	wei ren
为荣	wei rong
微软	wei ruan
为什么	wei shen me
为什么会	wei shen me hui
为什么要	wei shen me yao
卫生	wei sheng
卫生部	wei sheng bu
卫生间	wei sheng jian
卫生局	wei sheng ju
维生素	wei sheng su
微生物	wei sheng wu
为实现	wei shi xian
为首	wei shou
猥琐	wei suo
为他	wei ta
为她	wei ta
为他们	wei ta men
委托	wei tuo
委托人	wei tuo ren
威望	wei wang
为我	wei wo
为我们	wei wo men
危险	wei xian
危险的	wei xian de
微笑	wei xiao
微笑着	wei xiao zhe
威胁	wei xie
微信	wei xin
卫星	wei xing
微型	wei xing
维修	wei xiu
尾页	wei ye
唯一	wei yi
为宜	wei yi
唯一的	wei yi de
为一体	wei yi ti
唯有	wei you
为由	wei you
位于	wei yu
委员	wei yuan
委员会	wei yuan hui
违约	wei yue
违约金	wei yue jin
伪造	wei zao
位置	wei zhi
未知	wei zhi
为止	wei zhi
为之	wei zhi
为重点	wei zhong dian
为中心	wei zhong xin
为主	wei zhu
未注册	wei zhu ce
为主题	wei zhu ti
为主体	wei zhu ti
为准	wei zhun
为自己	wei zi ji
文本	wen ben
稳步	wen bu
文档	wen dang
问道	wen dao
稳定	wen ding
稳定的	wen ding de
稳定性	wen ding xing
温度	wen du
文革	wen ge
温和	wen he
问候	wen hou
文化	wen hua
文化部	wen hua bu
文化产业	wen hua chan ye
文化建设	wen hua jian she
文件	wen jian
文件大小	wen jian da xiao
文件的	wen jian de
文件夹	wen jian jia
文件名	wen jian ming
文件中	wen jian zhong
文科	wen ke
问了	wen le
文明	wen ming
温暖	wen nuan
文凭	wen ping
温泉	wen quan
温柔	wen rou
文书	wen shu
问他	wen ta
问题	wen ti
文体	wen ti
问题是	wen ti shi
问我	wen wo
文物	wen wu
文献	wen xian
温馨	wen xin
文学	wen xue
文艺	wen yi
问一句	wen yi ju
文章	wen zhang
文章来源	wen zhang lai yuan
温州	wen zhou
温州市	wen zhou shi
文字	wen zi
我爱	wo ai
我爱你	wo ai ni
我把	wo ba
我不	wo bu
我不会	wo bu hui
我不能	wo bu neng
我不是	wo bu shi
我不想	wo bu xiang
我不知道	wo bu zhi dao
我才	wo cai
我从	wo cong
我当时	wo dang shi
我到	wo dao
我的	wo de
我的心	wo de xin
我都	wo dou
我对	wo dui
沃尔玛	wo er ma
我发现	wo fa xian
我给	wo gei
我跟	wo gen
我公司	wo gong si
我国	wo guo
我还	wo hai
我还是	wo hai shi
我好	wo hao
我和	wo he
我很	wo hen
我会	wo hui
我家	wo jia
我将	wo jiang
我叫	wo jiao
我就	wo jiu
我就是	wo jiu shi
我局	wo ju
我觉得	wo jue de
我看	wo kan
我可	wo ke
我可以	wo ke yi
我来	wo lai
我没	wo mei
我没有	wo mei you
我们	wo men
我们把	wo men ba
我们必须	wo men bi xu
我们不	wo men bu
我们从	wo men cong
我们党	wo men dang
我们公司	wo men gong si
我们将	wo men jiang
我们就	wo men jiu
我们可以	wo men ke yi
我们认为	wo men ren wei
我们是	wo men shi
我们要	wo men yao
我们也	wo men ye
我们应该	wo men ying gai
我们有	wo men you
我们知道	wo men zhi dao
我们自己	wo men zi ji
我能	wo neng
我去	wo qu
我区	wo qu
我却	wo que
我认为	wo ren wei
我省	wo sheng
我是	wo shi
我市	wo shi
卧室	wo shi
我是一个	wo shi yi ge
我说	wo shuo
我司	wo si
我所	wo suo
我为	wo wei
我问	wo wen
我喜欢	wo xi huan
我希望	wo xi wang
我现在	wo xian zai
我想	wo xiang
我相信	wo xiang xin
我校	wo xiao
我心里	wo xin li
我要	wo yao
我也	wo ye
我也不	wo ye bu
我也是	wo ye shi
我已	wo yi
我已经	wo yi jing
我一直	wo yi zhi
我用	wo yong
我有	wo you
我又	wo you
我院	wo yuan
我在	wo zai
我怎么	wo zen me
我站	wo zhan
我这	wo zhe
我真	wo zhen
我正	wo zheng
我只	wo zhi
我知道	wo zhi dao
我只是	wo zhi shi
我终于	wo zhong yu
我自己	wo zi ji
我最	wo zui
我做	wo zuo
无比	wu bi
务必	wu bi
无不	wu bu
午餐	wu can
误差	wu cha
五大	wu da
舞蹈	wu dao
误导	wu dao
无敌	wu di
无底线	wu di xian
屋顶	wu ding
无法	wu fa
无法下载	wu fa xia zai
五个	wu ge
五个亿	wu ge yi
武功	wu gong
无关	wu guan
武汉	wu han
武汉市	wu han shi
误会	wu hui
误解	wu jie
物理	wu li
无力	wu li
屋里	wu li
无聊	wu liao
物料	wu liao
武林	wu lin
物流	wu liu
五六	wu liu
乌鲁木齐	wu lu mu qi
无论	wu lun
无论如何	wu lun ru he
无论是	wu lun shi
无门无派	wu men wu pai
无名	wu ming
无奈	wu nai
五年	wu nian
物品	wu pin
武器	wu qi
无情	wu qing
无穷	wu qiong
误区	wu qu
无权	wu quan
污染	wu ran
污染物	wu ran wu
无人	wu ren
侮辱	wu ru
五十	wu shi
务实	wu shi
武士	wu shi
无数	wu shu
武术	wu shu
污水	wu shui
无所谓	wu suo wei
舞台	wu tai
物体	wu ti
无畏	wu wei
无锡	wu xi
无锡市	wu xi shi
武侠	wu xia
无线	wu xian
无限	wu xian
无限的	wu xian de
无线电	wu xian dian
无效	wu xiao
无形	wu xing
五行	wu xing
无形资产	wu xing zi chan
无须	wu xu
物业	wu ye
物业管理	wu ye guan li
无疑	wu yi
五一	wu yi
无意	wu yi
无疑是	wu yi shi
无忧	wu you
五月	wu yue
物质	wu zhi
无知	wu zhi
物质的	wu zhi de
武装	wu zhuang
物资	wu zi
喜爱	xi ai
西安市	xi an shi
西班牙	xi ban ya
细胞	xi bao
西北	xi bei
西部	xi bu
西部地区	xi bu di qu
西方	xi fang
细分	xi fen
西瓜	xi gua
习惯	xi guan
习惯了	xi guan le
喜好	xi hao
西红柿	xi hong shi
西湖	xi hu
细化	xi hua
喜欢	xi huan
袭击	xi ji
细节	xi jie
洗净	xi jing
喜剧	xi ju
细菌	xi jun
希腊	xi la
系列	xi lie
系列产品	xi lie chan pin
西路	xi lu
西门	xi men
西门子	xi men zi
吸纳	xi na
西南	xi nan
细腻	xi ni
戏曲	xi qu
吸取	xi qu
昔日	xi ri
牺牲	xi sheng
吸收	xi shou
习俗	xi su
习题	xi ti
系统	xi tong
系统中	xi tong zhong
希望	xi wang
希望大家	xi wang da jia
希望能	xi wang neng
细心	xi xin
吸烟	xi yan
洗衣机	xi yi ji
吸引	xi yin
吸引了	xi yin le
吸引力	xi yin li
喜悦	xi yue
西藏	xi zang
洗澡	xi zao
细则	xi ze
细致	xi zhi
下班	xia ban
下半年	xia ban nian
下车	xia che
下次	xia ci
下达	xia da
下的	xia de
吓得	xia de
下跌	xia die
下发	xia fa
下方	xia fang
峡谷	xia gu
下滑	xia hua
夏季	xia ji
下级	xia ji
下降	xia jiang
侠客	xia ke
下来	xia lai
下了	xia le
下列	xia lie
厦门	xia men
厦门市	xia men shi
下面	xia mian
下去	xia qu
辖区	xia qu
下设	xia she
下属	xia shu
夏天	xia tian
下午	xia wu
下线	xia xian
下旬	xia xun
下一步	xia yi bu
下一代	xia yi dai
下一个	xia yi ge
下一批	xia yi pi
下一篇	xia yi pian
下一页	xia yi ye
下一主题	xia yi zhu ti
下游	xia you
下载	xia zai
下载次数	xia zai ci shu
下载地址	xia zai di zhi
下载后	xia zai hou
下载说明	xia zai shuo ming
下载速度	xia zai su du
先把	xian ba
现场	xian chang
县城	xian cheng
线程	xian cheng
现代	xian dai
现代化	xian dai hua
现代化的	xian dai hua de
显得	xian de
限定	xian ding
限额	xian e
宪法	xian fa
先锋	xian feng
先后	xian hou
鲜花	xian hua
现货	xian huo
县级	xian ji
县级以上	xian ji yi shang
现价	xian jia
现将	xian jiang
先将	xian jiang
衔接	xian jie
现金	xian jin
先进	xian jin
先进单位	xian jin dan wei
先进的	xian jin de
先进技术	xian jin ji shu
先进性	xian jin xing
陷阱	xian jing
显卡	xian ka
鲜明	xian ming
鲜明的	xian ming de
羡慕	xian mu
嫌弃	xian qi
限期	xian qi
掀起	xian qi
先前	xian qian
显然	xian ran
显然是	xian ran shi
现任	xian ren
陷入	xian ru
线上	xian shang
先生	xian sheng
显示	xian shi
现实	xian shi
先是	xian shi
显示出	xian shi chu
现实的	xian shi de
显示的	xian shi de
显示屏	xian shi ping
显示器	xian shi qi
线索	xian suo
先天	xian tian
线条	xian tiao
纤维	xian wei
县委	xian wei
显现	xian xian
现象	xian xiang
现行	xian xing
先行	xian xing
鲜血	xian xue
现已	xian yi
现有	xian you
现在	xian zai
现在就	xian zai jiu
现在是	xian zai shi
现在已经	xian zai yi jing
县政府	xian zheng fu
限制	xian zhi
显著	xian zhu
显著的	xian zhu de
现状	xian zhuang
相爱	xiang ai
想把	xiang ba
相比	xiang bi
想不到	xiang bu dao
相册	xiang ce
相差	xiang cha
相处	xiang chu
乡村	xiang cun
相当	xiang dang
相当于	xiang dang yu
想到	xiang dao
向导	xiang dao
想的	xiang de
相抵触	xiang di chu
相对	xiang dui
相对于	xiang dui yu
想法	xiang fa
相反	xiang fan
香港	xiang gang
像个	xiang ge
想个	xiang ge
相关	xiang guan
相关部门	xiang guan bu men
相关产品	xiang guan chan pin
相关法律	xiang guan fa lv
相关内容	xiang guan nei rong
相关评论	xiang guan ping lun
相关图片	xiang guan tu pian
相关文章	xiang guan wen zhang
相关信息	xiang guan xin xi
相关专业	xiang guan zhuan ye
相关资料	xiang guan zi liao
想过	xiang guo
相互	xiang hu
相机	xiang ji
相继	xiang ji
向记者	xiang ji zhe
橡胶	xiang jiao
香蕉	xiang jiao
相结合	xiang jie he
相结合的	xiang jie he de
想了	xiang le
相连	xiang lian
项链	xiang lian
项目	xiang mu
项目管理	xiang mu guan li
项目建设	xiang mu jian she
项目经理	xiang mu jing li
项目名称	xiang mu ming cheng
向你	xiang ni
相片	xiang pian
想起	xiang qi
响起	xiang qi
香气	xiang qi
向前	xiang qian
详情	xiang qing
想去	xiang qu
想让	xiang rang
向上	xiang shang
向社会	xiang she hui
像是	xiang shi
相识	xiang shi
相适应	xiang shi ying
享受	xiang shou
享受到	xiang shou dao
香水	xiang shui
相似	xiang si
像素	xiang su
向他	xiang ta
相同	xiang tong
向外	xiang wai
向往	xiang wang
香味	xiang wei
向我	xiang wo
详细	xiang xi
详细地址	xiang xi di zhi
详细介绍	xiang xi jie shao
详细内容	xiang xi nei rong
详细说明	xiang xi shuo ming
详细信息	xiang xi xin xi
详细资料	xiang xi zi liao
向下	xiang xia
想象	xiang xiang
想象的	xiang xiang de
相信	xiang xin
香烟	xiang yan
想要	xiang yao
相应	xiang ying
响应	xiang ying
享有	xiang you
相遇	xiang yu
想在	xiang zai
想着	xiang zhe
乡镇	xiang zhen
乡镇企业	xiang zhen qi ye
象征	xiang zheng
想做	xiang zuo
小吃	xiao chi
消除	xiao chu
笑道	xiao dao
小的	xiao de
小弟	xiao di
笑点	xiao dian
小店	xiao dian
消毒	xiao du
小儿	xiao er
消防	xiao fang
消费	xiao fei
消费品	xiao fei pin
消费者	xiao fei zhe
小狗	xiao gou
效果	xiao guo
小孩	xiao hai
小孩子	xiao hai zi
消耗	xiao hao
消化	xiao hua
笑话	xiao hua
销毁	xiao hui
小伙子	xiao huo zi
小姐	xiao jie
笑了	xiao le
笑了笑	xiao le xiao
效力	xiao li
销量	xiao liang
效率	xiao lv
小麦	xiao mai
消灭	xiao mie
效能	xiao neng
小女孩	xiao nv hai
小朋友	xiao peng you
小企业	xiao qi ye
小区	xiao qu
校区	xiao qu
小人	xiao ren
笑容	xiao rong
潇洒	xiao sa
笑声	xiao sheng
小时	xiao shi
消失	xiao shi
小事	xiao shi
小时候	xiao shi hou
消失了	xiao shi le
小时内	xiao shi nei
销售	xiao shou
销售额	xiao shou e
销售人员	xiao shou ren yuan
销售收入	xiao shou shou ru
小说	xiao shuo
小偷	xiao tou
消息	xiao xi
小心	xiao xin
小型	xiao xing
小学	xiao xue
小学生	xiao xue sheng
逍遥	xiao yao
效益	xiao yi
效应	xiao ying
校友	xiao you
小游戏	xiao you xi
小于	xiao yu
小雨	xiao yu
校园	xiao yuan
校长	xiao zhang
笑着	xiao zhe
小镇	xiao zhen
小子	xiao zi
小组	xiao zu
写出	xie chu
携带	xie dai
写的	xie de
写得	xie de
邪恶	xie e
协会	xie hui
写了	xie le
泄露	xie lou
泄漏	xie lou
写入	xie ru
协商	xie shang
携手	xie shou
协调	xie tiao
协调发展	xie tiao fa zhan
协同	xie tong
谢文东	xie wen dong
写下	xie xia
血压	xie ya
血液循环	xie ye xun huan
协议	xie yi
卸载	xie zai
写着	xie zhe
写真	xie zhen
协助	xie zhu
鞋子	xie zi
写字楼	xie zi lou
写作	xie zuo
协作	xie zuo
新版	xin ban
新材料	xin cai liao
新产品	xin chan pin
新车	xin che
新城	xin cheng
薪酬	xin chou
信贷	xin dai
新的	xin de
心得	xin de
心底	xin di
信访	xin fang
新高	xin gao
信鸽	xin ge
新股	xin gu
信号	xin hao
新华	xin hua
新华社	xin hua she
新华网	xin hua wang
新回复	xin hui fu
新技术	xin ji shu
新加坡	xin jia po
新建	xin jian
信件	xin jian
新疆	xin jiang
新课程	xin ke cheng
辛苦	xin ku
新款	xin kuan
信赖	xin lai
新浪	xin lang
心里	xin li
心理	xin li
心理健康	xin li jian kang
心理学	xin li xue
心灵	xin ling
心目中	xin mu zhong
新年	xin nian
信念	xin nian
新娘	xin niang
芯片	xin pian
芯片组	xin pian zu
新品	xin pin
心情	xin qing
新区	xin qu
信任	xin ren
新人	xin ren
欣赏	xin shang
新生	xin sheng
新世纪	xin shi ji
新时期	xin shi qi
新手	xin shou
新手上路	xin shou shang lu
薪水	xin shui
心思	xin si
心态	xin tai
心跳	xin tiao
新帖	xin tie
心头	xin tou
信托	xin tuo
新闻	xin wen
新闻媒体	xin wen mei ti
信息	xin xi
信息安全	xin xi an quan
信息产业	xin xi chan ye
信息发布	xin xi fa bu
信息服务	xin xi fu wu
信息管理	xin xi guan li
信息化	xin xi hua
信息技术	xin xi ji shu
信息来源	xin xi lai yuan
新西兰	xin xi lan
信息内容	xin xi nei rong
信息披露	xin xi pi lu
信息网	xin xi wang
信息网络	xin xi wang luo
信息系统	xin xi xi tong
信息中心	xin xi zhong xin
新鲜	xin xian
信箱	xin xiang
心想	xin xiang
信心	xin xin
新型	xin xing
新兴	xin xing
信仰	xin yang
新药	xin yao
新一代	xin yi dai
新一轮	xin yi lun
新颖	xin ying
信用	xin yong
信用卡	xin yong ka
信用证	xin yong zheng
信誉	xin yu
心愿	xin yuan
心脏	xin zang
新增	xin zeng
心中	xin zhong
薪资	xin zi
性爱	xing ai
性别	xing bie
形成	xing cheng
行程	xing cheng
形成了	xing cheng le
行动	xing dong
刑法	xing fa
兴奋	xing fen
幸福	xing fu
幸福的	xing fu de
性感	xing gan
性格	xing ge
星光	xing guang
型号	xing hao
幸好	xing hao
星级	xing ji
性价比	xing jia bi
兴建	xing jian
性交	xing jiao
星空	xing kong
醒来	xing lai
行了	xing le
行李	xing li
姓名	xing ming
性命	xing ming
醒目	xing mu
性能	xing neng
兴起	xing qi
星期	xing qi
星期六	xing qi liu
星期四	xing qi si
星期五	xing qi wu
兴趣	xing qu
行人	xing ren
形容	xing rong
性生活	xing sheng huo
形式	xing shi
形势	xing shi
行使	xing shi
行驶	xing shi
形式的	xing shi de
刑事法律	xing shi fa lv
形态	xing tai
行为	xing wei
形象	xing xiang
性欲	xing yu
幸运	xing yun
行政	xing zheng
行政部门	xing zheng bu men
行政处罚	xing zheng chu fa
行政处分	xing zheng chu fen
行政法规	xing zheng fa gui
行政复议	xing zheng fu yi
行政管理	xing zheng guan li
行政机关	xing zheng ji guan
行政许可	xing zheng xu ke
行政执法	xing zheng zhi fa
行政主管	xing zheng zhu guan
性质	xing zhi
形状	xing zhuang
行走	xing zou
星座	xing zuo
胸部	xiong bu
兄弟	xiong di
雄厚	xiong hou
胸口	xiong kou
熊猫	xiong mao
胸前	xiong qian
修订	xiu ding
修复	xiu fu
修改	xiu gai
修建	xiu jian
修理	xiu li
修炼	xiu lian
修饰	xiu shi
休息	xiu xi
休闲	xiu xian
修行	xiu xing
修养	xiu yang
修正	xiu zheng
许多	xu duo
许多人	xu duo ren
序号	xu hao
虚假	xu jia
许可	xu ke
许可证	xu ke zheng
序列	xu lie
序列号	xu lie hao
续命	xu ming
畜牧	xu mu
畜牧业	xu mu ye
虚拟	xu ni
虚拟主机	xu ni zhu ji
需求	xu qiu
需求量	xu qiu liang
叙述	xu shu
需要	xu yao
须要	xu yao
需要在	xu yao zai
须知	xu zhi
徐州	xu zhou
选拔	xuan ba
宣布	xuan bu
选出	xuan chu
宣传	xuan chuan
宣传部	xuan chuan bu
宣传教育	xuan chuan jiao yu
选定	xuan ding
选购	xuan gou
悬挂	xuan gua
选举	xuan ju
旋律	xuan lv
选取	xuan qu
渲染	xuan ran
选手	xuan shou
玄武	xuan wu
选项	xuan xiang
宣言	xuan yan
选用	xuan yong
选择	xuan ze
选择了	xuan ze le
选择题	xuan ze ti
选中	xuan zhong
旋转	xuan zhuan
学报	xue bao
学到	xue dao
学的	xue de
学费	xue fei
学分	xue fen
血管	xue guan
学会	xue hui
学科	xue ke
学历	xue li
学期	xue qi
雪山	xue shan
学生	xue sheng
学生们	xue sheng men
学时	xue shi
学术	xue shu
学说	xue shuo
学位	xue wei
学问	xue wen
学习	xue xi
学习型	xue xi xing
学校	xue xiao
血压	xue ya
血液	xue ye
学业	xue ye
血液循环	xue ye xun huan
学院	xue yuan
学员	xue yuan
学者	xue zhe
学子	xue zi
循环	xun huan
循环经济	xun huan jing ji
询价	xun jia
迅雷	xun lei
训练	xun lian
寻求	xun qiu
迅速	xun su
迅速发展	xun su fa zhan
询问	xun wen
勋章	xun zhang
寻找	xun zhao
牙齿	ya chi
雅阁	ya ge
雅虎	ya hu
压力	ya li
压迫	ya po
雅思	ya si
压缩	ya suo
丫头	ya tou
压抑	ya yi
亚洲	ya zhou
延安	yan an
演变	yan bian
烟草	yan cao
延长	yan chang
演唱	yan chang
演唱会	yan chang hui
延迟	yan chi
演出	yan chu
研发	yan fa
严格	yan ge
严格按照	yan ge an zhao
严格的	yan ge de
严格执行	yan ge zhi xing
沿海	yan hai
演讲	yan jiang
严禁	yan jin
严谨	yan jin
眼睛	yan jing
眼镜	yan jing
研究	yan jiu
研究成果	yan jiu cheng guo
研究会	yan jiu hui
研究开发	yan jiu kai fa
研究人员	yan jiu ren yuan
研究生	yan jiu sheng
研究所	yan jiu suo
研究院	yan jiu yuan
研究员	yan jiu yuan
研究中心	yan jiu zhong xin
严峻	yan jun
眼泪	yan lei
眼里	yan li
言论	yan lun
严密	yan mi
延期	yan qi
眼前	yan qian
眼球	yan qiu
颜色	yan se
眼神	yan shen
延伸	yan shen
演示	yan shi
岩石	yan shi
验收	yan shou
严肃	yan su
烟台	yan tai
研讨	yan tao
研讨会	yan tao hui
沿途	yan tu
延续	yan xu
演绎	yan yi
言语	yan yu
演员	yan yuan
沿着	yan zhe
验证	yan zheng
炎症	yan zheng
验证码	yan zheng ma
研制	yan zhi
严重	yan zhong
眼中	yan zhong
严重的	yan zhong de
严重影响	yan zhong ying xiang
演奏	yan zou
样板	yang ban
养成	yang cheng
阳光	yang guang
央行	yang hang
养护	yang hu
氧化	yang hua
养老	yang lao
养老保险	yang lao bao xian
样品	yang pin
氧气	yang qi
羊肉	yang rou
养生	yang sheng
样式	yang shi
央视	yang shi
阳台	yang tai
养殖	yang zhi
扬州	yang zhou
样子	yang zi
要把	yao ba
要比	yao bi
要不	yao bu
药材	yao cai
要充分	yao chong fen
要从	yao cong
要到	yao dao
要的	yao de
要点	yao dian
药店	yao dian
要对	yao dui
要多	yao duo
要给	yao gei
要根据	yao gen ju
摇滚	yao gun
要好	yao hao
要和	yao he
要加	yao jia
要加强	yao jia qiang
要坚持	yao jian chi
要建立	yao jian li
要将	yao jiang
要进行	yao jin xing
要进一步	yao jin yi bu
要看	yao kan
要靠	yao kao
遥控	yao kong
遥控器	yao kong qi
要么	yao me
药品	yao pin
邀请	yao qing
要求	yao qiu
要去	yao qu
要让	yao rang
要认真	yao ren zhen
要是	yao shi
钥匙	yao shi
要使	yao shi
要说	yao shuo
要素	yao su
要通过	yao tong guo
摇头	yao tou
要为	yao wei
要我	yao wo
药物	yao wu
要先	yao xian
要想	yao xiang
要向	yao xiang
要严格	yao yan ge
要以	yao yi
要用	yao yong
要有	yao you
要与	yao yu
要约	yao yue
要在	yao zai
咬在	yao zai
要知道	yao zhi dao
要注意	yao zhu yi
要走	yao zou
要做	yao zuo
也被	ye bei
也比	ye bi
也不	ye bu
也不会	ye bu hui
也不能	ye bu neng
也不要	ye bu yao
也不知道	ye bu zhi dao
也曾	ye ceng
页次	ye ci
也从	ye cong
也得	ye dei
也都	ye dou
也对	ye dui
也给	ye gei
也好	ye hao
也很	ye hen
也会	ye hui
业绩	ye ji
夜间	ye jian
也将	ye jiang
业界	ye jie
冶金	ye jin
液晶	ye jing
也就	ye jiu
也就是	ye jiu shi
也就是说	ye jiu shi shuo
也开始	ye kai shi
也可	ye ke
也可能	ye ke neng
也可以	ye ke yi
夜里	ye li
也没	ye mei
也没有	ye mei you
页面	ye mian
业内	ye nei
业内人士	ye nei ren shi
也能	ye neng
叶片	ye pian
也让	ye rang
野生	ye sheng
野生动物	ye sheng dong wu
也是	ye shi
也使	ye shi
也是一种	ye shi yi zhong
页数	ye shu
也说	ye shuo
也算	ye suan
液体	ye ti
夜晚	ye wan
也为	ye wei
业务	ye wu
也无法	ye wu fa
业务员	ye wu yuan
也想	ye xiang
也许	ye xu
也许是	ye xu shi
也需要	ye xu yao
液压	ye ya
也要	ye yao
也已	ye yi
也应	ye ying
也应该	ye ying gai
也有	ye you
业余	ye yu
也在	ye zai
也正	ye zheng
也只	ye zhi
业主	ye zhu
叶子	ye zi
一按	yi an
已按	yi an
一把	yi ba
一百	yi bai
一般	yi ban
一般的	yi ban de
一般都	yi ban dou
一般来说	yi ban lai shuo
一般人	yi ban ren
以保证	yi bao zheng
已被	yi bei
一杯	yi bei
一倍	yi bei
一辈子	yi bei zi
一本	yi ben
一笔	yi bi
一边	yi bian
以便	yi bian
一遍	yi bian
一边吃	yi bian chi
仪表	yi biao
一并	yi bing
一部	yi bu
一步	yi bu
亦不	yi bu
已不	yi bu
一部分	yi bu fen
一层	yi ceng
遗产	yi chan
一场	yi chang
异常	yi chang
已成	yi cheng
已成为	yi cheng wei
一处	yi chu
遗传	yi chuan
乙醇	yi chun
一次	yi ci
以此	yi ci
依次	yi ci
一词	yi ci
一次性	yi ci xing
一大	yi da
益达	yi da
已达	yi da
意大利	yi da li
一大批	yi da pi
一代	yi dai
一带	yi dai
一旦	yi dan
一道	yi dao
一到	yi dao
一等奖	yi deng jiang
异地	yi di
一点	yi dian
一点点	yi dian dian
一点也	yi dian ye
一定	yi ding
一定会	yi ding hui
一定是	yi ding shi
一定要	yi ding yao
移动	yi dong
移动电话	yi dong dian hua
一度	yi du
一段	yi duan
一段时间	yi duan shi jian
一堆	yi dui
一对	yi dui
一顿	yi dun
亿吨	yi dun
一二三四	yi er san si
依法	yi fa
依法行政	yi fa xing zheng
乙方	yi fang
一方	yi fang
以防	yi fang
一方面	yi fang mian
一份	yi fen
一分	yi fen
一封	yi feng
衣服	yi fu
一副	yi fu
一幅	yi fu
一个	yi ge
一个个	yi ge ge
一个人	yi ge ren
一个人的	yi ge ren de
一个是	yi ge shi
一个问题	yi ge wen ti
一个新的	yi ge xin de
一个月	yi ge yue
一个字	yi ge zi
一根	yi gen
一共	yi gong
一股	yi gu
遗憾	yi han
一行	yi hang
一号	yi hao
以后	yi hou
一会	yi hui
一回	yi hui
一会儿	yi hui er
疑惑	yi huo
以及	yi ji
一级	yi ji
已记录	yi ji lu
以及其他	yi ji qi ta
一家	yi jia
意见	yi jian
一件	yi jian
一间	yi jian
一件事	yi jian shi
移交	yi jiao
一脚	yi jiao
已经	yi jing
一经	yi jing
意境	yi jing
已经被	yi jing bei
已经成为	yi jing cheng wei
已经开始	yi jing kai shi
已经是	yi jing shi
已经有	yi jing you
已经在	yi jing zai
依旧	yi jiu
一九	yi jiu
依据	yi ju
一句	yi ju
一举	yi ju
一句话	yi ju hua
一开始	yi kai shi
一看	yi kan
依靠	yi kao
一颗	yi ke
亦可	yi ke
一刻	yi ke
一口	yi kou
一口气	yi kou qi
一块	yi kuai
一款	yi kuan
伊拉克	yi la ke
以来	yi lai
依赖	yi lai
伊朗	yi lang
一类	yi lei
一脸	yi lian
一辆	yi liang
医疗	yi liao
医疗保险	yi liao bao xian
医疗费	yi liao fei
医疗机构	yi liao ji gou
医疗器械	yi liao qi xie
医疗卫生	yi liao wei sheng
一流	yi liu
一楼	yi lou
一路	yi lu
一轮	yi lun
一律	yi lv
一枚	yi mei
一门	yi men
一面	yi mian
以免	yi mian
疫苗	yi miao
移民	yi min
一名	yi ming
佚名	yi ming
以内	yi nei
一年	yi nian
一年级	yi nian ji
一旁	yi pang
一批	yi pi
一片	yi pian
一篇	yi pian
一起	yi qi
仪器	yi qi
义气	yi qi
以其	yi qi
一齐	yi qi
一期	yi qi
一起去	yi qi qu
以前	yi qian
一千	yi qian
一切	yi qie
一切都	yi qie dou
疫情	yi qing
一圈	yi quan
一群	yi qun
依然	yi ran
依然是	yi ran shi
一人	yi ren
艺人	yi ren
以任何	yi ren he
以人为本	yi ren wei ben
一日	yi ri
以色列	yi se lie
以上	yi shang
以上版本	yi shang ban ben
以上学历	yi shang xue li
一身	yi shen
一审	yi shen
一声	yi sheng
医生	yi sheng
一生	yi sheng
一是	yi shi
意识	yi shi
一时	yi shi
已是	yi shi
仪式	yi shi
医师	yi shi
一事	yi shi
以使	yi shi
意识到	yi shi dao
意识的	yi shi de
一时间	yi shi jian
意识形态	yi shi xing tai
一首	yi shou
一手	yi shou
艺术	yi shu
一书	yi shu
艺术的	yi shu de
艺术家	yi shu jia
艺术类	yi shu lei
艺术品	yi shu pin
一双	yi shuang
一说	yi shuo
意思	yi si
意思是	yi si shi
一所	yi suo
一台	yi tai
以太网	yi tai wang
一套	yi tao
一体	yi ti
以提高	yi ti gao
一体化	yi ti hua
一天	yi tian
一条	yi tiao
一听	yi ting
一同	yi tong
一头	yi tou
意图	yi tu
依托	yi tuo
一坨	yi tuo
意外	yi wai
以外的	yi wai de
一万	yi wan
已完成	yi wan cheng
以往	yi wang
遗忘	yi wang
以为	yi wei
一位	yi wei
一味	yi wei
意味	yi wei
意味着	yi wei zhe
疑问	yi wen
义务	yi wu
衣物	yi wu
义务教育	yi wu jiao yu
一系列	yi xi lie
一系列的	yi xi lie de
一下	yi xia
以下简称	yi xia jian cheng
以下内容	yi xia nei rong
一下子	yi xia zi
一线	yi xian
一项	yi xiang
意向	yi xiang
一向	yi xiang
一笑	yi xiao
一些	yi xie
一些人	yi xie ren
一些问题	yi xie wen ti
一心	yi xin
一行	yi xing
异性	yi xing
医学	yi xue
医学院	yi xue yuan
一眼	yi yan
一样	yi yang
医药	yi yao
一夜	yi ye
一页	yi ye
意义	yi yi
异议	yi yi
意义的	yi yi de
意义上	yi yi shang
已有	yi you
亦有	yi you
易于	yi yu
已于	yi yu
医院	yi yuan
亿元	yi yuan
意愿	yi yuan
医院的	yi yuan de
一月	yi yue
已在	yi zai
一再	yi zai
一张	yi zhang
依照	yi zhao
一阵	yi zhen
一直	yi zhi
一只	yi zhi
一支	yi zhi
一致	yi zhi
抑制	yi zhi
抑止	yi zhi
意志	yi zhi
以致	yi zhi
已知	yi zhi
以至	yi zhi
移植	yi zhi
遗址	yi zhi
一致的	yi zhi de
一直没有	yi zhi mei you
一直是	yi zhi shi
一直使用	yi zhi shi yong
一直是用	yi zhi shi yong
一直以来	yi zhi yi lai
以至于	yi zhi yu
一直在	yi zhi zai
一种	yi zhong
一众	yi zhong
一周	yi zhou
椅子	yi zi
一组	yi zu
一族	yi zu
一座	yi zuo
银币	yin bi
隐藏	yin cang
因此	yin ci
因此而	yin ci er
因此在	yin ci zai
引导	yin dao
阴道	yin dao
引导学生	yin dao xue sheng
印度	yin du
因而	yin er
引发	yin fa
印发	yin fa
银行	yin hang
银行卡	yin hang ka
银行业	yin hang ye
印花税	yin hua shui
隐患	yin huan
淫秽	yin hui
引进	yin jin
阴茎	yin jing
饮酒	yin jiu
饮料	yin liao
引领	yin ling
隐瞒	yin man
阴谋	yin mou
音频	yin pin
引起	yin qi
因其	yin qi
引起了	yin qi le
引擎	yin qing
引入	yin ru
银色	yin se
隐身	yin shen
饮食	yin shi
印刷	yin shua
饮水	yin shui
隐私	yin si
因素	yin su
因为	yin wei
因为你	yin wei ni
因为他	yin wei ta
因为她	yin wei ta
因为我	yin wei wo
印象	yin xiang
音响	yin xiang
音箱	yin xiang
音像	yin xiang
音效	yin xiao
阴阳	yin yang
阴影	yin ying
引用	yin yong
饮用	yin yong
饮用水	yin yong shui
音乐	yin yue
印章	yin zhang
银子	yin zi
因子	yin zi
应按	ying an
英镑	ying bang
英寸	ying cun
应当	ying dang
应当在	ying dang zai
赢得	ying de
赢得了	ying de le
应对	ying dui
婴儿	ying er
应付	ying fu
应该	ying gai
应该是	ying gai shi
应该说	ying gai shuo
应该在	ying gai zai
应根据	ying gen ju
英国	ying guo
应急	ying ji
硬件	ying jian
应将	ying jiang
迎接	ying jie
硬盘	ying pan
影片	ying pian
应聘	ying pin
应聘者	ying pin zhe
影视	ying shi
影史	ying shi
应是	ying shi
英特尔	ying te er
应为	ying wei
英文	ying wen
影响	ying xiang
影像	ying xiang
影响到	ying xiang dao
影响力	ying xiang li
营销	ying xiao
英雄	ying xiong
营养	ying yang
营业	ying ye
营业部	ying ye bu
营业税	ying ye shui
营业执照	ying ye zhi zhao
应以	ying yi
影音	ying yin
应用	ying yong
应用程序	ying yong cheng xu
应用的	ying yong de
应用软件	ying yong ruan jian
应用于	ying yong yu
应有	ying you
应由	ying you
英语	ying yu
影院	ying yuan
营运	ying yun
应在	ying zai
营造	ying zao
应注意	ying zhu yi
影子	ying zi
拥抱	yong bao
永不	yong bu
用餐	yong can
用车	yong che
用到	yong dao
用的	yong de
用地	yong di
用电	yong dian
用法	yong fa
勇敢	yong gan
用过	yong guo
永恒	yong heng
用户	yong hu
拥护	yong hu
用户可以	yong hu ke yi
用户名	yong hu ming
用户提供	yong hu ti gong
用户组	yong hu zu
佣金	yong jin
永久	yong jiu
用具	yong ju
用来	yong lai
用了	yong le
用力	yong li
用量	yong liang
用品	yong pin
勇气	yong qi
用人	yong ren
用人单位	yong ren dan wei
用手	yong shou
用水	yong shui
用途	yong tu
用心	yong xin
用心的	yong xin de
用药	yong yao
用以	yong yi
拥有	yong you
拥有的	yong you de
用于	yong yu
勇于	yong yu
永远	yong yuan
永远的	yong yuan de
永远是	yong yuan shi
用在	yong zai
用作	yong zuo
又被	you bei
有必要	you bi yao
右边	you bian
有不	you bu
又不	you bu
有不少	you bu shao
有不同	you bu tong
右侧	you ce
有车	you che
又称	you cheng
由此	you ci
由此可见	you ci ke jian
有的	you de
有的人	you de ren
有点	you dian
优点	you dian
有多	you duo
有多少	you duo shao
幼儿	you er
幼儿园	you er yuan
诱发	you fa
有丰富的	you feng fu de
有个	you ge
有更多的	you geng duo de
有关	you guan
有关部门	you guan bu men
有关单位	you guan dan wei
有关法律	you guan fa lv
有关规定	you guan gui ding
有关人员	you guan ren yuan
有关事项	you guan shi xiang
有关问题	you guan wen ti
有过	you guo
由国家	you guo jia
由国务院	you guo wu yuan
有害	you hai
友好	you hao
油耗	you hao
有何	you he
有很大	you hen da
有很多	you hen duo
优化	you hua
油画	you hua
优惠	you hui
又会	you hui
优惠价	you hui jia
优惠政策	you hui zheng ce
诱惑	you huo
有机	you ji
邮寄	you ji
有几个	you ji ge
有计划	you ji hua
有机会	you ji hui
邮件	you jian
右键	you jian
又将	you jiang
邮局	you ju
游客	you ke
又可	you ke
有可能	you ke neng
有空	you kong
游览	you lan
有了	you le
有力	you li
有利	you li
有力的	you li de
有利于	you li yu
优良	you liang
优良的	you liang de
有两个	you liang ge
有两种	you liang zhong
优美	you mei
优美的	you mei de
有没有	you mei you
游民	you min
有名的	you ming de
有明显	you ming xian
幽默	you mo
油墨	you mo
有哪些	you na xie
又能	you neng
有你	you ni
邮票	you piao
尤其	you qi
有期徒刑	you qi tu xing
有钱	you qian
友情	you qing
友情链接	you qing lian jie
有趣	you qu
有趣的	you qu de
有权	you quan
有人	you ren
游人	you ren
有任何	you ren he
有人说	you ren shuo
犹如	you ru
有色金属	you se jin shu
有什么	you shen me
由省	you sheng
优势	you shi
有时	you shi
又是	you shi
有事	you shi
优势的	you shi de
有时候	you shi hou
有时间	you shi jian
右手	you shou
又说	you shuo
有所	you suo
有条件的	you tiao jian de
有望	you wang
有问题	you wen ti
有无	you wu
游戏	you xi
游戏中	you xi zhong
有下列	you xia lie
优先	you xian
有限	you xian
有线	you xian
有限的	you xian de
有线电视	you xian dian shi
有限公司	you xian gong si
邮箱	you xiang
有效	you xiao
有效的	you xiao de
有效期	you xiao qi
有效性	you xiao xing
有些	you xie
有些人	you xie ren
有新	you xin
有兴趣	you xing qu
优秀	you xiu
有序	you xu
有许多	you xu duo
优雅	you ya
又要	you yao
有一	you yi
友谊	you yi
有意	you yi
有益	you yi
又一	you yi
有一次	you yi ci
又一次	you yi ci
有益的	you yi de
有一定	you yi ding
有一个	you yi ge
有一天	you yi tian
有以下	you yi xia
有一些	you yi xie
有意者	you yi zhe
有一种	you yi zhong
有用	you yong
游泳	you yong
游泳池	you yong chi
又有	you you
由于	you yu
犹豫	you yu
优越	you yue
又在	you zai
有着	you zhe
有这样	you zhe yang
有针对性	you zhen dui xing
邮政	you zheng
邮政编码	you zheng bian ma
优质	you zhi
油脂	you zhi
优质的	you zhi de
有种	you zhong
由中国	you zhong guo
有助于	you zhu yu
有自己	you zi ji
预案	yu an
预报	yu bao
预备	yu bei
与本站	yu ben zhan
预测	yu ce
于此	yu ci
与此同时	yu ci tong shi
遇到	yu dao
遇到了	yu dao le
余额	yu e
语法	yu fa
与发展	yu fa zhan
预防	yu fang
与否	yu fou
与服务	yu fu wu
与管理	yu guan li
与国际	yu guo ji
预计	yu ji
与技术	yu ji shu
瑜伽	yu jia
遇见	yu jian
预警	yu jing
与经济	yu jing ji
语句	yu ju
与客户	yu ke hu
愉快	yu kuai
愉快的	yu kuai de
预览	yu lan
娱乐	yu le
鱼类	yu lei
舆论	yu lun
郁闷	yu men
玉米	yu mi
域名	yu ming
域名注册	yu ming zhu ce
域内	yu nei
与你	yu ni
余年	yu nian
与您	yu nin
与其	yu qi
预期	yu qi
逾期	yu qi
语气	yu qi
与企业	yu qi ye
与人	yu ren
遇上	yu shang
与社会	yu she hui
于是	yu shi
浴室	yu shi
与时俱进	yu shi ju jin
雨水	yu shui
预算	yu suan
与他	yu ta
欲望	yu wang
语文	yu wen
与我	yu wo
与我们	yu wo men
预先	yu xian
与信息	yu xin xi
语言	yu yan
语言种类	yu yan zhong lei
渔业	yu ye
予以	yu yi
语音	yu yin
与应用	yu ying yong
预约	yu yue
愉悦	yu yue
与之	yu zhi
语种	yu zhong
与中国	yu zhong guo
宇宙	yu zhou
元宝	yuan bao
原本	yuan ben
原材料	yuan cai liao
远程	yuan cheng
远程教育	yuan cheng jiao yu
远处	yuan chu
原创	yuan chuang
源代码	yuan dai ma
元旦	yuan dan
原告	yuan gao
员工	yuan gong
缘故	yuan gu
原价	yuan jia
原件	yuan jian
元件	yuan jian
原来	yuan lai
原来是	yuan lai shi
元老	yuan lao
原理	yuan li
远离	yuan li
原谅	yuan liang
原料	yuan liao
园林	yuan lin
源码	yuan ma
圆满	yuan man
元钱	yuan qian
元人民币	yuan ren min bi
原始	yuan shi
院士	yuan shi
元素	yuan su
原帖	yuan tie
源头	yuan tou
愿望	yuan wang
原文	yuan wen
原先	yuan xian
院校	yuan xiao
圆形	yuan xing
鸳鸯	yuan yang
愿意	yuan yi
原因	yuan yin
原因是	yuan yin shi
原因之一	yuan yin zhi yi
缘由	yuan you
源于	yuan yu
原则	yuan ze
原则上	yuan ze shang
院长	yuan zhang
援助	yuan zhu
原装	yuan zhuang
原作者	yuan zuo zhe
月饼	yue bing
月初	yue chu
越大	yue da
月的	yue de
月底	yue di
约定	yue ding
阅读	yue du
阅读次数	yue du ci shu
阅读权限	yue du quan xian
阅读者	yue du zhe
乐队	yue dui
越多	yue duo
月份	yue fen
越高	yue gao
月光	yue guang
约翰	yue han
约会	yue hui
月经	yue jing
越来越	yue lai yue
越来越大	yue lai yue da
越来越多	yue lai yue duo
月亮	yue liang
越南	yue nan
月内	yue nei
乐器	yue qi
越是	yue shi
约束	yue shu
约为	yue wei
月薪	yue xin
越野车	yue ye che
粤语	yue yu
约占	yue zhan
越职	yue zhi
月至	yue zhi
运动	yun dong
运动员	yun dong yuan
运费	yun fei
孕妇	yun fu
云南	yun nan
云南省	yun nan sheng
运气	yun qi
运输	yun shu
运算	yun suan
运行	yun xing
运行环境	yun xing huan jing
运行平台	yun xing ping tai
允许	yun xu
运营	yun ying
运营商	yun ying shang
运用	yun yong
运转	yun zhuan
运作	yun zuo
杂志	za zhi
杂志社	za zhi she
再把	zai ba
在被	zai bei
在北京	zai bei jing
在不同	zai bu tong
在产品	zai chan pin
再尝试	zai chang shi
再次	zai ci
在此	zai ci
在当地	zai dang di
再到	zai dao
在地	zai di
再度	zai du
在对	zai dui
在高	zai gao
在公司	zai gong si
在工作	zai gong zuo
在广州	zai guang zhou
在国际	zai guo ji
在国家	zai guo jia
在国内	zai guo nei
在过去	zai guo qu
在国外	zai guo wai
灾害	zai hai
在乎	zai hu
在家	zai jia
再加	zai jia
在家里	zai jia li
再加上	zai jia shang
再见	zai jian
再将	zai jiang
在接受	zai jie shou
在今年	zai jin nian
在进行	zai jin xing
在经济	zai jing ji
再就业	zai jiu ye
再看	zai kan
再来	zai lai
在没有	zai mei you
在那	zai na
在那里	zai na li
在哪里	zai na li
灾难	zai nan
在内	zai nei
在你	zai ni
在您	zai nin
栽培	zai pei
在其	zai qi
在企业	zai qi ye
在前	zai qian
再去	zai qu
在全球	zai quan qiu
在人	zai ren
在日本	zai ri ben
载入	zai ru
在上	zai shang
在社会	zai she hui
在深圳	zai shen zhen
再生	zai sheng
在生产	zai sheng chan
在市场	zai shi chang
在实际	zai shi ji
在世界	zai shi jie
在使用	zai shi yong
再说	zai shuo
在他	zai ta
在她	zai ta
载体	zai ti
在外	zai wai
在网络	zai wang luo
在网上	zai wang shang
在网站	zai wang zhan
在为	zai wei
在未来	zai wei lai
在我	zai wo
在我国	zai wo guo
在我们的	zai wo men de
在下	zai xia
在线	zai xian
再现	zai xian
在线时间	zai xian shi jian
在想	zai xiang
在香港	zai xiang gang
在校	zai xiao
再新	zai xin
在学校	zai xue xiao
再也	zai ye
在意	zai yi
再一次	zai yi ci
在一定	zai yi ding
在一起	zai yi qi
在一些	zai yi xie
再用	zai yong
再有	zai you
在于	zai yu
在与	zai yu
在这	zai zhe
在这方面	zai zhe fang mian
在这个	zai zhe ge
在这里	zai zhe li
在这里的	zai zhe li de
在这些	zai zhe xie
在这样的	zai zhe yang de
在这种	zai zhe zhong
在整个	zai zheng ge
在职	zai zhi
在中	zai zhong
在中国	zai zhong guo
在自己	zai zi ji
在做	zai zuo
赞美	zan mei
咱们	zan men
暂时	zan shi
暂时没有	zan shi mei you
暂停	zan ting
赞同	zan tong
暂无	zan wu
赞助	zan zhu
藏族	zang zu
早餐	zao can
早餐后	zao can hou
早晨	zao chen
造成	zao cheng
造成了	zao cheng le
遭到	zao dao
早点	zao dian
造访	zao fang
造价	zao jia
早就	zao jiu
造就	zao jiu
早期	zao qi
早日	zao ri
早上	zao shang
噪声	zao sheng
遭受	zao shou
早晚	zao wan
造型	zao xing
早已	zao yi
噪音	zao yin
遭遇	zao yu
早在	zao zai
则不	ze bu
则会	ze hui
则可	ze ke
责令	ze ling
责任	ze ren
责任编辑	ze ren bian ji
责任感	ze ren gan
责任人	ze ren ren
责任制	ze ren zhi
则是	ze shi
则为	ze wei
则有	ze you
则在	ze zai
怎么	zen me
怎么办	zen me ban
怎么会	zen me hui
怎么回事	zen me hui shi
怎么了	zen me le
怎么样	zen me yang
怎么也	zen me ye
怎样	zen yang
增大	zeng da
增多	zeng duo
增幅	zeng fu
增高	zeng gao
增加	zeng jia
增加到	zeng jia dao
增加了	zeng jia le
增进	zeng jin
增强	zeng qiang
增强了	zeng qiang le
增收	zeng shou
赠送	zeng song
增速	zeng su
增添	zeng tian
增长	zeng zhang
增长了	zeng zhang le
增长率	zeng zhang lv
增值	zeng zhi
增值税	zeng zhi shui
炸弹	zha dan
扎实	zha shi
债券	zhai quan
债权	zhai quan
债权人	zhai quan ren
债务	zhai wu
债务人	zhai wu ren
摘要	zhai yao
摘自	zhai zi
战场	zhan chang
站成	zhan cheng
展出	zhan chu
占到	zhan dao
站的	zhan de
占地	zhan di
占地面积	zhan di mian ji
站点	zhan dian
战斗	zhan dou
战斗力	zhan dou li
展会	zhan hui
占据	zhan ju
展开	zhan kai
展览	zhan lan
展览会	zhan lan hui
占了	zhan le
站了	zhan le
占领	zhan ling
战略	zhan lve
站内	zhan nei
站起来	zhan qi lai
展区	zhan qu
战胜	zhan sheng
展示	zhan shi
战士	zhan shi
战时	zhan shi
展示了	zhan shi le
战术	zhan shu
粘贴	zhan tie
展位	zhan wei
展现	zhan xian
崭新的	zhan xin de
战役	zhan yi
占用	zhan yong
占有	zhan you
站在	zhan zai
站长	zhan zhang
站着	zhan zhe
战争	zhan zheng
障碍	zhang ai
章程	zhang cheng
长大	zhang da
长得	zhang de
长得快	zhang de kuai
丈夫	zhang fu
涨幅	zhang fu
账号	zhang hao
账户	zhang hu
涨价	zhang jia
章节	zhang jie
长老	zhang lao
帐篷	zhang peng
掌声	zhang sheng
掌握	zhang wo
掌握了	zhang wo le
招标	zhao biao
招标文件	zhao biao wen jian
找不到	zhao bu dao
找出	zhao chu
找到	zhao dao
找到了	zhao dao le
找个	zhao ge
找工作	zhao gong zuo
照顾	zhao gu
招呼	zhao hu
召唤	zhao huan
着急	zhao ji
召开	zhao kai
召开了	zhao kai le
找了	zhao le
照明	zhao ming
招募	zhao mu
招牌	zhao pai
照片	zhao pian
招聘	zhao pin
招聘会	zhao pin hui
招聘人数	zhao pin ren shu
招聘信息	zhao pin xin xi
招聘职位	zhao pin zhi wei
招商	zhao shang
招商引资	zhao shang yin zi
招生	zhao sheng
招收	zhao shou
招投标	zhao tou biao
找我	zhao wo
朝阳	zhao yang
这本	zhe ben
这边	zhe bian
这部	zhe bu
这不	zhe bu
这部分	zhe bu fen
这不是	zhe bu shi
这才	zhe cai
这场	zhe chang
这次	zhe ci
这点	zhe dian
这段	zhe duan
这对	zhe dui
这对于	zhe dui yu
这儿	zhe er
这方面	zhe fang mian
这方面的	zhe fang mian de
这份	zhe fen
这个	zhe ge
这个人	zhe ge ren
这个时候	zhe ge shi hou
这个世界	zhe ge shi jie
这个问题	zhe ge wen ti
这话	zhe hua
这几天	zhe ji tian
这家	zhe jia
这件事	zhe jian shi
浙江	zhe jiang
这将	zhe jiang
浙江省	zhe jiang sheng
这就	zhe jiu
这就去	zhe jiu qu
这就是	zhe jiu shi
这句话	zhe ju hua
这可	zhe ke
折扣	zhe kou
这块	zhe kuai
这款	zhe kuan
这类	zhe lei
这里	zhe li
这里是	zhe li shi
这里有	zhe li you
这两个	zhe liang ge
这两种	zhe liang zhong
这么	zhe me
这么多	zhe me duo
这么说	zhe me shuo
折磨	zhe mo
这篇	zhe pian
这片	zhe pian
这篇文章	zhe pian wen zhang
这让	zhe rang
这三个	zhe san ge
这是	zhe shi
这时	zhe shi
这事	zhe shi
这是个	zhe shi ge
这时候	zhe shi hou
这是一个	zhe shi yi ge
这是一种	zhe shi yi zhong
这是因为	zhe shi yin wei
这套	zhe tao
这天	zhe tian
这条	zhe tiao
这位	zhe wei
这项	zhe xiang
这些	zhe xie
这些都	zhe xie dou
这些都是	zhe xie dou shi
这些人	zhe xie ren
这些问题	zhe xie wen ti
哲学	zhe xue
这样	zhe yang
这样才能	zhe yang cai neng
这样就	zhe yang jiu
这样说	zhe yang shuo
这样一个	zhe yang yi ge
这样一来	zhe yang yi lai
这样做	zhe yang zuo
这也	zhe ye
者也	zhe ye
这也是	zhe ye shi
这一	zhe yi
这一次	zhe yi ci
这一点	zhe yi dian
这一切	zhe yi qie
这一天	zhe yi tian
这意味着	zhe yi wei zhe
这与	zhe yu
这在	zhe zai
这张	zhe zhang
这只	zhe zhi
这种	zhe zhong
这种方法	zhe zhong fang fa
这种方式	zhe zhong fang shi
这种情况	zhe zhong qing kuang
这座	zhe zuo
真诚	zhen cheng
真诚的	zhen cheng de
真的	zhen de
真的很	zhen de hen
真的是	zhen de shi
震动	zhen dong
诊断	zhen duan
针对	zhen dui
针对性	zhen dui xing
珍贵	zhen gui
震撼	zhen han
镇江	zhen jiang
真空	zhen kong
真理	zhen li
诊疗	zhen liao
真情	zhen qing
真人	zhen ren
真是	zhen shi
真实的	zhen shi de
真实性	zhen shi xing
珍惜	zhen xi
真相	zhen xiang
真心	zhen xin
振兴	zhen xing
真正	zhen zheng
珍珠	zhen zhu
正版	zheng ban
政策	zheng ce
正常	zheng chang
正常使用	zheng chang shi yong
整车	zheng che
正当	zheng dang
政党	zheng dang
正的	zheng de
征得	zheng de
征地	zheng di
整顿	zheng dun
争夺	zheng duo
政府	zheng fu
征服	zheng fu
政府部门	zheng fu bu men
政府采购	zheng fu cai gou
整改	zheng gai
整个	zheng ge
正规	zheng gui
正好	zheng hao
整合	zheng he
征集	zheng ji
整机	zheng ji
证件	zheng jian
整洁	zheng jie
拯救	zheng jiu
证据	zheng ju
整理	zheng li
争论	zheng lun
正面	zheng mian
证明	zheng ming
证明材料	zheng ming cai liao
证明了	zheng ming le
整齐	zheng qi
蒸气	zheng qi
蒸汽	zheng qi
挣钱	zheng qian
征求	zheng qiu
争取	zheng qu
证券	zheng quan
政权	zheng quan
证券公司	zheng quan gong si
证券市场	zheng quan shi chang
正确	zheng que
正确的	zheng que de
正如	zheng ru
正式	zheng shi
正是	zheng shi
证实	zheng shi
正式版	zheng shi ban
征收	zheng shou
证书	zheng shu
整体	zheng ti
整天	zheng tian
正文	zheng wen
政务	zheng wu
政务公开	zheng wu gong kai
政协	zheng xie
争议	zheng yi
正义	zheng yi
正在	zheng zai
挣扎	zheng zha
政治	zheng zhi
整治	zheng zhi
争执	zheng zhi
政治部	zheng zhi bu
郑州	zheng zhou
郑州市	zheng zhou shi
症状	zheng zhuang
治安	zhi an
值班	zhi ban
制备	zhi bei
制备方法	zhi bei fang fa
指标	zhi biao
直播	zhi bo
只不过	zhi bu guo
职场	zhi chang
支撑	zhi cheng
职称	zhi cheng
制成	zhi cheng
之称	zhi cheng
支持	zhi chi
支持下	zhi chi xia
指出	zhi chu
支出	zhi chu
之处	zhi chu
之初	zhi chu
至此	zhi ci
之大	zhi da
直达	zhi da
知道	zhi dao
指导	zhi dao
直到	zhi dao
之道	zhi dao
知道了	zhi dao le
指导思想	zhi dao si xiang
指导下	zhi dao xia
知道自己	zhi dao zi ji
值得	zhi de
指的	zhi de
只得	zhi de
织的	zhi de
指的是	zhi de shi
之地	zhi di
质地	zhi di
指点	zhi dian
指定	zhi ding
制定	zhi ding
制订	zhi ding
置顶	zhi ding
指定的	zhi ding de
制订的	zhi ding de
制定的	zhi ding de
制动	zhi dong
制度	zhi du
制度化	zhi du hua
制度建设	zhi du jian she
支队	zhi dui
之多	zhi duo
执法	zhi fa
执法人员	zhi fa ren yuan
脂肪	zhi fang
之分	zhi fen
支付	zhi fu
致富	zhi fu
支付宝	zhi fu bao
质感	zhi gan
职工	zhi gong
直观	zhi guan
支行	zhi hang
只好	zhi hao
之后	zhi hou
滞后	zhi hou
只会	zhi hui
智慧	zhi hui
指挥	zhi hui
指挥部	zhi hui bu
指挥官	zhi hui guan
之际	zhi ji
至极	zhi ji
之家	zhi jia
之间	zhi jian
只见	zhi jian
直接	zhi jie
至今	zhi jin
直径	zhi jing
之类	zhi lei
治理	zhi li
智力	zhi li
致力于	zhi li yu
质量	zhi liang
质量管理	zhi liang guan li
质量监督	zhi liang jian du
质量问题	zhi liang wen ti
治疗	zhi liao
指令	zhi ling
直流	zhi liu
之路	zhi lu
之旅	zhi lv
知名	zhi ming
知名的	zhi ming de
知名度	zhi ming du
指南	zhi nan
之内	zhi nei
支内	zhi nei
只能	zhi neng
职能部门	zhi neng bu men
智能化	zhi neng hua
只能在	zhi neng zai
支配	zhi pei
制品	zhi pin
之前	zhi qian
之前的	zhi qian de
之情	zhi qing
职权	zhi quan
之人	zhi ren
之日	zhi ri
之日起	zhi ri qi
之上	zhi shang
至上	zhi shang
至少	zhi shao
至少有	zhi shao you
之声	zhi sheng
只剩下	zhi sheng xia
只是	zhi shi
知识	zhi shi
之时	zhi shi
指示	zhi shi
致使	zhi shi
指使	zhi shi
之事	zhi shi
之势	zhi shi
知识产权	zhi shi chan quan
知识的	zhi shi de
知识分子	zhi shi fen zi
只是一个	zhi shi yi ge
只是在	zhi shi zai
指数	zhi shu
直属	zhi shu
之所	zhi suo
之所以	zhi suo yi
只听	zhi ting
之外	zhi wai
只为	zhi wei
职务	zhi wu
植物	zhi wu
织物	zhi wu
之下	zhi xia
直辖市	zhi xia shi
直线	zhi xian
只想	zhi xiang
指向	zhi xiang
直销	zhi xiao
之心	zhi xin
执行	zhi xing
之星	zhi xing
执行情况	zhi xing qing kuang
执行时间	zhi xing shi jian
只需	zhi xu
秩序	zhi xu
只需要	zhi xu yao
只要	zhi yao
制药	zhi yao
只要你	zhi yao ni
只要是	zhi yao shi
只要有	zhi yao you
职业	zhi ye
执业	zhi ye
职业病	zhi ye bing
职业道德	zhi ye dao de
职业技能	zhi ye ji neng
职业教育	zhi ye jiao yu
职业培训	zhi ye pei xun
职业资格	zhi ye zi ge
执业资格	zhi ye zi ge
之一	zhi yi
之意	zhi yi
质疑	zhi yi
指引	zhi yin
只用	zhi yong
只有	zhi you
只有一点	zhi you yi dian
只有一个	zhi you yi ge
只有在	zhi you zai
至于	zhi yu
置于	zhi yu
之余	zhi yu
治愈	zhi yu
只愿	zhi yuan
志愿	zhi yuan
支援	zhi yuan
职员	zhi yuan
志愿者	zhi yuan zhe
制约	zhi yue
只在	zhi zai
制造	zhi zao
制造商	zhi zao shang
制造业	zhi zao ye
职责	zhi ze
指责	zhi ze
纸张	zhi zhang
指着	zhi zhe
指针	zhi zhen
执政	zhi zheng
直至	zhi zhi
制止	zhi zhi
之中	zhi zhong
执着	zhi zhuo
制作	zhi zuo
之作	zhi zuo
制作的	zhi zuo de
中部	zhong bu
中不	zhong bu
仲裁	zhong cai
忠诚	zhong cheng
重大	zhong da
中大	zhong da
重大的	zhong da de
重大问题	zhong da wen ti
中的	zhong de
重的	zhong de
中得到	zhong de dao
中等	zhong deng
重点	zhong dian
终点	zhong dian
重点是	zhong dian shi
终点站	zhong dian zhan
中东	zhong dong
中毒	zhong du
终端	zhong duan
中断	zhong duan
众多	zhong duo
众多的	zhong duo de
中方	zhong fang
中共	zhong gong
中共中央	zhong gong zhong yang
中关村	zhong guan cun
中国	zhong guo
中国大陆	zhong guo da lu
中国电信	zhong guo dian xin
中国队	zhong guo dui
中国古代	zhong guo gu dai
中国国际	zhong guo guo ji
中国经济	zhong guo jing ji
中国企业	zhong guo qi ye
中国人	zhong guo ren
中国人民	zhong guo ren min
中国市场	zhong guo shi chang
中国文化	zhong guo wen hua
中国移动	zhong guo yi dong
中国银行	zhong guo yin hang
中国政府	zhong guo zheng fu
中华	zhong hua
中华民族	zhong hua min zu
终极	zhong ji
中级	zhong ji
中级会员	zhong ji hui yuan
中间	zhong jian
中奖	zhong jiang
中介	zhong jie
终结	zhong jie
中介机构	zhong jie ji gou
中来	zhong lai
中了	zhong le
种类	zhong lei
重量	zhong liang
肿瘤	zhong liu
中路	zhong lu
中美	zhong mei
中年	zhong nian
中期	zhong qi
中去	zhong qu
众人	zhong ren
中山	zhong shan
终身	zhong shen
众生	zhong sheng
终生	zhong sheng
重视	zhong shi
忠实	zhong shi
中说	zhong shuo
众所周知	zhong suo zhou zhi
中途	zhong tu
中外	zhong wai
中文	zhong wen
中文版	zhong wen ban
中午	zhong wu
中小	zhong xiao
中小企业	zhong xiao qi ye
中小学	zhong xiao xue
中心	zhong xin
重心	zhong xin
中性	zhong xing
中型	zhong xing
中学	zhong xue
中学生	zhong xue sheng
中旬	zhong xun
中央	zhong yang
中央军委	zhong yang jun wei
重要	zhong yao
中药	zhong yao
重要的	zhong yao de
重要讲话	zhong yao jiang hua
重要内容	zhong yao nei rong
重要思想	zhong yao si xiang
重要性	zhong yao xing
重要意义	zhong yao yi yi
重要组成	zhong yao zu cheng
重要作用	zhong yao zuo yong
中医	zhong yi
中医药	zhong yi yao
中有	zhong you
终于	zhong yu
中原	zhong yuan
种植	zhong zhi
终止	zhong zhi
中止	zhong zhi
中专	zhong zhuan
种子	zhong zi
种族	zhong zu
周边	zhou bian
轴承	zhou cheng
周到	zhou dao
周恩来	zhou en lai
周杰伦	zhou jie lun
周刊	zhou kan
周六	zhou liu
周末	zhou mo
周年	zhou nian
周期	zhou qi
周日	zhou ri
周四	zhou si
周岁	zhou sui
周围	zhou wei
皱纹	zhou wen
周五	zhou wu
周一	zhou yi
主办	zhu ban
主板	zhu ban
主办单位	zhu ban dan wei
珠宝	zhu bao
主编	zhu bian
逐步	zhu bu
注册	zhu ce
注册表	zhu ce biao
注册会员	zhu ce hui yuan
注册码	zhu ce ma
注册商标	zhu ce shang biao
注册时间	zhu ce shi jian
注册用户	zhu ce yong hu
注册资本	zhu ce zi ben
注册资金	zhu ce zi jin
主场	zhu chang
主持	zhu chi
主持人	zhu chi ren
贮存	zhu cun
主导	zhu dao
注定	zhu ding
主动	zhu dong
主动性	zhu dong xing
诸多	zhu duo
住房	zhu fang
祝福	zhu fu
主管	zhu guan
主观	zhu guan
主管部门	zhu guan bu men
主管人员	zhu guan ren yuan
珠海	zhu hai
祝贺	zhu he
主机	zhu ji
逐渐	zhu jian
主讲	zhu jiang
主角	zhu jue
住了	zhu le
助理	zhu li
主力	zhu li
主流	zhu liu
著名	zhu ming
注明	zhu ming
著名的	zhu ming de
逐年	zhu nian
主人	zhu ren
猪肉	zhu rou
诸如	zhu ru
注入	zhu ru
注射	zhu she
注释	zhu shi
助手	zhu shou
住宿	zhu su
住所	zhu suo
主题	zhu ti
主体	zhu ti
主席	zhu xi
注销	zhu xiao
助学	zhu xue
主演	zhu yan
主要	zhu yao
主要包括	zhu yao bao kuo
主要产品	zhu yao chan pin
主要领导	zhu yao ling dao
主要内容	zhu yao nei rong
主要任务	zhu yao ren wu
主要是	zhu yao shi
主要用于	zhu yao yong yu
主要有	zhu yao you
主要原因	zhu yao yuan yin
主页	zhu ye
注意	zhu yi
主义	zhu yi
主意	zhu yi
注意到	zhu yi dao
注意力	zhu yi li
注意事项	zhu yi shi xiang
主营	zhu ying
主营产品	zhu ying chan pin
主营业务	zhu ying ye wu
住院	zhu yuan
住在	zhu zai
铸造	zhu zao
住宅	zhu zhai
主张	zhu zhang
注重	zhu zhong
著作	zhu zuo
著作权	zhu zuo quan
抓好	zhua hao
抓紧	zhua jin
抓住	zhua zhu
转变	zhuan bian
专长	zhuan chang
转到	zhuan dao
转动	zhuan dong
转发	zhuan fa
专柜	zhuan gui
转化	zhuan hua
转化为	zhuan hua wei
转换	zhuan huan
专集	zhuan ji
专辑	zhuan ji
专家	zhuan jia
专家组	zhuan jia zu
专科	zhuan ke
专栏	zhuan lan
专利	zhuan li
专卖	zhuan mai
专卖店	zhuan mai dian
专门	zhuan men
赚钱	zhuan qian
专区	zhuan qu
转让	zhuan rang
专人	zhuan ren
转入	zhuan ru
转身	zhuan shen
转速	zhuan su
专题	zhuan ti
转贴	zhuan tie
转帖	zhuan tie
转为	zhuan wei
专为	zhuan wei
专线	zhuan xian
转向	zhuan xiang
专项	zhuan xiang
专项资金	zhuan xiang zi jin
撰写	zhuan xie
转型	zhuan xing
专业	zhuan ye
专业从事	zhuan ye cong shi
专业化	zhuan ye hua
专业技术	zhuan ye ji shu
专业人士	zhuan ye ren shi
专业人员	zhuan ye ren yuan
专业生产	zhuan ye sheng chan
专业性	zhuan ye xing
专业知识	zhuan ye zhi shi
转移	zhuan yi
转移到	zhuan yi dao
专用	zhuan yong
转载	zhuan zai
专职	zhuan zhi
专注	zhuan zhu
专著	zhuan zhu
转自	zhuan zi
装备	zhuang bei
壮大	zhuang da
状况	zhuang kuang
装配	zhuang pei
装饰	zhuang shi
状态	zhuang tai
状态下	zhuang tai xia
装修	zhuang xiu
装置	zhuang zhi
追究	zhui jiu
追求	zhui qiu
追逐	zhui zhu
追踪	zhui zong
准备	zhun bei
准备工作	zhun bei gong zuo
准确	zhun que
准确性	zhun que xing
准予	zhun yu
准则	zhun ze
着力	zhuo li
桌面	zhuo mian
桌上	zhuo shang
着手	zhuo shou
卓越	zhuo yue
卓越的	zhuo yue de
着重	zhuo zhong
桌子	zhuo zi
资本	zi ben
资本市场	zi ben shi chang
资本主义	zi ben zhu yi
淄博	zi bo
资产	zi chan
资产评估	zi chan ping gu
自从	zi cong
自带	zi dai
子弹	zi dan
字的	zi de
自定义	zi ding yi
自动	zi dong
自动化	zi dong hua
字段	zi duan
资费	zi fei
自费	zi fei
字符	zi fu
自负	zi fu
字符串	zi fu chuan
资格	zi ge
资格证书	zi ge zheng shu
子宫	zi gong
子公司	zi gong si
字号	zi hao
自己	zi ji
自己干	zi ji gan
字节	zi jie
资金	zi jin
自觉	zi jue
自觉地	zi jue de
自考	zi kao
子类	zi lei
自理	zi li
资料	zi liao
自律	zi lv
字母	zi mu
字幕	zi mu
子女	zi nv
自然	zi ran
自然的	zi ran de
自然科学	zi ran ke xue
自然是	zi ran shi
滋润	zi run
紫色	zi se
自杀	zi sha
自身	zi shen
资深	zi shen
自身的	zi shen de
姿势	zi shi
字数	zi shu
姿态	zi tai
字体	zi ti
滋味	zi wei
自我	zi wo
仔细	zi xi
仔细阅读	zi xi yue du
自信	zi xin
自行	zi xing
自行车	zi xing che
自学	zi xue
咨询	zi xun
资讯	zi xun
咨询电话	zi xun dian hua
咨询服务	zi xun fu wu
字样	zi yang
自由	zi you
自有	zi you
自由的	zi you de
资源	zi yuan
自愿	zi yuan
自在	zi zai
资质	zi zhi
自治	zi zhi
自制	zi zhi
自治区	zi zhi qu
自主	zi zhu
资助	zi zhu
自助	zi zhu
自主创新	zi zhu chuang xin
总按	zong an
总版主	zong ban zhu
总部	zong bu
总裁	zong cai
总的	zong de
总额	zong e
总分	zong fen
总共	zong gong
总公司	zong gong si
综合	zong he
综合素质	zong he su zhi
综合性	zong he xing
纵横	zong heng
总会	zong hui
总计	zong ji
总监	zong jian
宗教	zong jiao
总结	zong jie
总经理	zong jing li
总局	zong ju
总理	zong li
总量	zong liang
总面积	zong mian ji
总是	zong shi
总数	zong shu
总算	zong suan
总体	zong ti
总统	zong tong
总投资	zong tou zi
总线	zong xian
总嫌	zong xian
总有	zong you
总在	zong zai
总则	zong ze
总之	zong zhi
走出	zou chu
走出去	zou chu qu
走到	zou dao
走过	zou guo
走进	zou jin
走廊	zou lang
走了	zou le
走路	zou lu
走去	zou qu
走上	zou shang
走势	zou shi
走向	zou xiang
走在	zou zai
阻碍	zu ai
组成	zu cheng
组成部分	zu cheng bu fen
组的	zu de
租房	zu fang
足够	zu gou
祖国	zu guo
组合	zu he
组建	zu jian
组件	zu jian
租金	zu jin
阻力	zu li
租赁	zu lin
足球	zu qiu
组团	zu tuan
组委会	zu wei hui
足以	zu yi
租用	zu yong
组长	zu zhang
组织	zu zhi
阻止	zu zhi
组织部	zu zhi bu
组织机构	zu zhi ji gou
组织开展	zu zhi kai zhan
组织实施	zu zhi shi shi
组装	zu zhuang
钻石	zuan shi
最爱	zui ai
嘴巴	zui ba
最长	zui chang
最初	zui chu
嘴唇	zui chun
最大	zui da
最大化	zui da hua
最大限度	zui da xian du
最低	zui di
最短	zui duan
最多	zui duo
最高	zui gao
最好	zui hao
最好是	zui hao shi
最后	zui hou
最后登录	zui hou deng lu
最后发表	zui hou fa biao
最后更新	zui hou geng xin
最后一个	zui hou yi ge
最基本	zui ji ben
最佳	zui jia
嘴角	zui jiao
最近	zui jin
最具	zui ju
最快	zui kuai
嘴里	zui li
最美	zui mei
最强	zui qiang
最少	zui shao
最适合	zui shi he
最为	zui wei
最喜欢的	zui xi huan de
最先进	zui xian jin
最小	zui xiao
最新	zui xin
最新版	zui xin ban
最有	zui you
最有效	zui you xiao
最早	zui zao
最终	zui zhong
最重要	zui zhong yao
最重要的	zui zhong yao de
最主要的	zui zhu yao de
尊敬	zun jing
遵守	zun shou
遵循	zun xun
尊严	zun yan
尊重	zun zhong
做爱	zuo ai
作弊	zuo bi
左边	zuo bian
坐标	zuo biao
左侧	zuo ce
做成	zuo cheng
做出	zuo chu
做出了	zuo chu le
做到	zuo dao
做到了	zuo dao le
做的	zuo de
做得	zuo de
做法	zuo fa
做饭	zuo fan
作风	zuo feng
做个	zuo ge
做工	zuo gong
做过	zuo guo
做好	zuo hao
作家	zuo jia
做了	zuo le
坐了	zuo le
作品	zuo pin
做起	zuo qi
做人	zuo ren
昨日	zuo ri
做什么	zuo shen me
做事	zuo shi
左手	zuo shou
座谈	zuo tan
座谈会	zuo tan hui
昨天	zuo tian
作为	zuo wei
座位	zuo wei
作为一个	zuo wei yi ge
作文	zuo wen
作物	zuo wu
坐下	zuo xia
作业	zuo ye
座椅	zuo yi
做一个	zuo yi ge
作用	zuo yong
左右	zuo you
左右的	zuo you de
坐在	zuo zai
做在	zuo zai
作战	zuo zhan
作者	zuo zhe
坐着	zuo zhe
做作业时	zuo zuo ye shi